aaa	AAA						
aab	AAB						
aac	AAC						
aad	AAD						
aae	AAE						
aaf	AAF						
aag	AAG						
aah	AAH						
aai	AAI						
aak	AAK						
aal	AAL						
aan	AAN						
aao	AAO						
aap	AAP						
aaq	AAQ						
aar	AAR	AAR	aar	AAR	aar	aa	AA
aas	AAS						
aat	AAT						
aau	AAU						
aaw	AAW						
aax	AAX						
aaz	AAZ						
aba	ABA						
abb	ABB						
abc	ABC						
abd	ABD						
abe	ABE						
abf	ABF						
abg	ABG						
abh	ABH						
abi	ABI						
abj	ABJ						
abk	ABK	ABK	abk	ABK	abk	ab	AB
abl	ABL						
abm	ABM						
abn	ABN						
abo	ABO						
abp	ABP						
abq	ABQ						
abr	ABR						
abs	ABS						
abt	ABT						
abu	ABU						
abv	ABV						
abw	ABW						
abx	ABX						
aby	ABY						
abz	ABZ						
aca	ACA						
acb	ACB						
acd	ACD						
ace	ACE	ACE	ace	ACE	ace		
acf	ACF						
ach	ACH	ACH	ach	ACH	ach		
aci	ACI						
ack	ACK						
acl	ACL						
acm	ACM						
acn	ACN						
acp	ACP						
acq	ACQ						
acr	ACR						
acs	ACS						
act	ACT						
acu	ACU						
acv	ACV						
acw	ACW						
acx	ACX						
acy	ACY						
acz	ACZ						
ada	ADA	ADA	ada	ADA	ada		
adb	ADB						
add	ADD						
ade	ADE						
adf	ADF						
adg	ADG						
adh	ADH						
adi	ADI						
adj	ADJ						
adl	ADL						
adn	ADN						
ado	ADO						
adq	ADQ						
adr	ADR						
ads	ADS						
adt	ADT						
adu	ADU						
adw	ADW						
adx	ADX						
ady	ADY	ADY	ady	ADY	ady		
adz	ADZ						
aea	AEA						
aeb	AEB						
aec	AEC						
aed	AED						
aee	AEE						
aek	AEK						
ael	AEL						
aem	AEM						
aen	AEN						
aeq	AEQ						
aer	AER						
aes	AES						
aeu	AEU						
aew	AEW						
aey	AEY						
aez	AEZ						
afb	AFB						
afd	AFD						
afe	AFE						
afg	AFG						
afh	AFH	AFH	afh	AFH	afh		
afi	AFI						
afk	AFK						
afn	AFN						
afo	AFO						
afp	AFP						
afr	AFR	AFR	afr	AFR	afr	af	AF
afs	AFS						
aft	AFT						
afu	AFU						
afz	AFZ						
aga	AGA						
agb	AGB						
agc	AGC						
agd	AGD						
age	AGE						
agf	AGF						
agg	AGG						
agh	AGH						
agi	AGI						
agj	AGJ						
agk	AGK						
agl	AGL						
agm	AGM						
agn	AGN						
ago	AGO						
agq	AGQ						
agr	AGR						
ags	AGS						
agt	AGT						
agu	AGU						
agv	AGV						
agw	AGW						
agx	AGX						
agy	AGY						
agz	AGZ						
aha	AHA						
ahb	AHB						
ahg	AHG						
ahh	AHH						
ahi	AHI						
ahk	AHK						
ahl	AHL						
ahm	AHM						
ahn	AHN						
aho	AHO						
ahp	AHP						
ahr	AHR						
ahs	AHS						
aht	AHT						
aia	AIA						
aib	AIB						
aic	AIC						
aid	AID						
aie	AIE						
aif	AIF						
aig	AIG						
aih	AIH						
aii	AII						
aij	AIJ						
aik	AIK						
ail	AIL						
aim	AIM						
ain	AIN	AIN	ain	AIN	ain		
aio	AIO						
aip	AIP						
aiq	AIQ						
air	AIR						
ait	AIT						
aiw	AIW						
aix	AIX						
aiy	AIY						
aja	AJA						
ajg	AJG						
aji	AJI						
ajn	AJN						
ajp	AJP						
ajt	AJT						
aju	AJU						
ajw	AJW						
ajz	AJZ						
aka	AKA	AKA	aka	AKA	aka	ak	AK
akb	AKB						
akc	AKC						
akd	AKD						
ake	AKE						
akf	AKF						
akg	AKG						
akh	AKH						
aki	AKI						
akj	AKJ						
akk	AKK	AKK	akk	AKK	akk		
akl	AKL						
akm	AKM						
ako	AKO						
akp	AKP						
akq	AKQ						
akr	AKR						
aks	AKS						
akt	AKT						
aku	AKU						
akv	AKV						
akw	AKW						
akx	AKX						
aky	AKY						
akz	AKZ						
ala	ALA						
alc	ALC						
ald	ALD						
ale	ALE	ALE	ale	ALE	ale		
alf	ALF						
alh	ALH						
ali	ALI						
alj	ALJ						
alk	ALK						
all	ALL						
alm	ALM						
aln	ALN						
alo	ALO						
alp	ALP						
alq	ALQ						
alr	ALR						
als	ALS						
alt	ALT	ALT	alt	ALT	alt		
alu	ALU						
alw	ALW						
alx	ALX						
aly	ALY						
alz	ALZ						
ama	AMA						
amb	AMB						
amc	AMC						
ame	AME						
amf	AMF						
amg	AMG						
amh	AMH	AMH	amh	AMH	amh	am	AM
ami	AMI						
amj	AMJ						
amk	AMK						
aml	AML						
amm	AMM						
amn	AMN						
amo	AMO						
amp	AMP						
amq	AMQ						
amr	AMR						
ams	AMS						
amt	AMT						
amu	AMU						
amv	AMV						
amw	AMW						
amx	AMX						
amy	AMY						
amz	AMZ						
ana	ANA						
anb	ANB						
anc	ANC						
and	AND						
ane	ANE						
anf	ANF						
ang	ANG	ANG	ang	ANG	ang		
anh	ANH						
ani	ANI						
anj	ANJ						
ank	ANK						
anl	ANL						
anm	ANM						
ann	ANN						
ano	ANO						
anp	ANP	ANP	anp	ANP	anp		
anq	ANQ						
anr	ANR						
ans	ANS						
ant	ANT						
anu	ANU						
anv	ANV						
anw	ANW						
anx	ANX						
any	ANY						
anz	ANZ						
aoa	AOA						
aob	AOB						
aoc	AOC						
aod	AOD						
aoe	AOE						
aof	AOF						
aog	AOG						
aoi	AOI						
aoj	AOJ						
aok	AOK						
aol	AOL						
aom	AOM						
aon	AON						
aor	AOR						
aos	AOS						
aot	AOT						
aou	AOU						
aox	AOX						
aoz	AOZ						
apb	APB						
apc	APC						
apd	APD						
ape	APE						
apf	APF						
apg	APG						
aph	APH						
api	API						
apj	APJ						
apk	APK						
apl	APL						
apm	APM						
apn	APN						
apo	APO						
app	APP						
apq	APQ						
apr	APR						
aps	APS						
apt	APT						
apu	APU						
apv	APV						
apw	APW						
apx	APX						
apy	APY						
apz	APZ						
aqc	AQC						
aqd	AQD						
aqg	AQG						
aqm	AQM						
aqn	AQN						
aqp	AQP						
aqr	AQR						
aqt	AQT						
aqz	AQZ						
ara	ARA	ARA	ara	ARA	ara	ar	AR
arb	ARB						
arc	ARC	ARC	arc	ARC	arc		
ard	ARD						
are	ARE						
arg	ARG	ARG	arg	ARG	arg	an	AN
arh	ARH						
ari	ARI						
arj	ARJ						
ark	ARK						
arl	ARL						
arn	ARN	ARN	arn	ARN	arn		
aro	ARO						
arp	ARP	ARP	arp	ARP	arp		
arq	ARQ						
arr	ARR						
ars	ARS						
aru	ARU						
arv	ARV						
arw	ARW	ARW	arw	ARW	arw		
arx	ARX						
ary	ARY						
arz	ARZ						
asa	ASA						
asb	ASB						
asc	ASC						
ase	ASE						
asf	ASF						
asg	ASG						
ash	ASH						
asi	ASI						
asj	ASJ						
ask	ASK						
asl	ASL						
asm	ASM	ASM	asm	ASM	asm	as	AS
asn	ASN						
aso	ASO						
asp	ASP						
asq	ASQ						
asr	ASR						
ass	ASS						
ast	AST	AST	ast	AST	ast		
asu	ASU						
asv	ASV						
asw	ASW						
asx	ASX						
asy	ASY						
asz	ASZ						
ata	ATA						
atb	ATB						
atc	ATC						
atd	ATD						
ate	ATE						
atg	ATG						
ati	ATI						
atj	ATJ						
atk	ATK						
atl	ATL						
atm	ATM						
atn	ATN						
ato	ATO						
atp	ATP						
atq	ATQ						
atr	ATR						
ats	ATS						
att	ATT						
atu	ATU						
atv	ATV						
atw	ATW						
atx	ATX						
aty	ATY						
atz	ATZ						
aua	AUA						
aub	AUB						
auc	AUC						
aud	AUD						
aug	AUG						
auh	AUH						
aui	AUI						
auj	AUJ						
auk	AUK						
aul	AUL						
aum	AUM						
aun	AUN						
auo	AUO						
aup	AUP						
auq	AUQ						
aur	AUR						
aut	AUT						
auu	AUU						
auw	AUW						
aux	AUX						
auy	AUY						
auz	AUZ						
ava	AVA	AVA	ava	AVA	ava	av	AV
avb	AVB						
avd	AVD						
ave	AVE	AVE	ave	AVE	ave	ae	AE
avi	AVI						
avk	AVK						
avl	AVL						
avm	AVM						
avn	AVN						
avo	AVO						
avs	AVS						
avt	AVT						
avu	AVU						
avv	AVV						
awa	AWA	AWA	awa	AWA	awa		
awb	AWB						
awc	AWC						
awe	AWE						
awg	AWG						
awh	AWH						
awi	AWI						
awk	AWK						
awm	AWM						
awn	AWN						
awo	AWO						
awr	AWR						
aws	AWS						
awt	AWT						
awu	AWU						
awv	AWV						
aww	AWW						
awx	AWX						
awy	AWY						
axb	AXB						
axe	AXE						
axg	AXG						
axk	AXK						
axl	AXL						
axm	AXM						
axx	AXX						
aya	AYA						
ayb	AYB						
ayc	AYC						
ayd	AYD						
aye	AYE						
ayg	AYG						
ayh	AYH						
ayi	AYI						
ayk	AYK						
ayl	AYL						
aym	AYM	AYM	aym	AYM	aym	ay	AY
ayn	AYN						
ayo	AYO						
ayp	AYP						
ayq	AYQ						
ayr	AYR						
ays	AYS						
ayt	AYT						
ayu	AYU						
ayz	AYZ						
aza	AZA						
azb	AZB						
azd	AZD						
aze	AZE	AZE	aze	AZE	aze	az	AZ
azg	AZG						
azj	AZJ						
azm	AZM						
azn	AZN						
azo	AZO						
azt	AZT						
azz	AZZ						
baa	BAA						
bab	BAB						
bac	BAC						
bae	BAE						
baf	BAF						
bag	BAG						
bah	BAH						
baj	BAJ						
bak	BAK	BAK	bak	BAK	bak	ba	BA
bal	BAL	BAL	bal	BAL	bal		
bam	BAM	BAM	bam	BAM	bam	bm	BM
ban	BAN	BAN	ban	BAN	ban		
bao	BAO						
bap	BAP						
bar	BAR						
bas	BAS	BAS	bas	BAS	bas		
bau	BAU						
bav	BAV						
baw	BAW						
bax	BAX						
bay	BAY						
bba	BBA						
bbb	BBB						
bbc	BBC						
bbd	BBD						
bbe	BBE						
bbf	BBF						
bbg	BBG						
bbh	BBH						
bbi	BBI						
bbj	BBJ						
bbk	BBK						
bbl	BBL						
bbm	BBM						
bbn	BBN						
bbo	BBO						
bbp	BBP						
bbq	BBQ						
bbr	BBR						
bbs	BBS						
bbt	BBT						
bbu	BBU						
bbv	BBV						
bbw	BBW						
bbx	BBX						
bby	BBY						
bca	BCA						
bcb	BCB						
bcc	BCC						
bcd	BCD						
bce	BCE						
bcf	BCF						
bcg	BCG						
bch	BCH						
bci	BCI						
bcj	BCJ						
bck	BCK						
bcl	BCL						
bcm	BCM						
bcn	BCN						
bco	BCO						
bcp	BCP						
bcq	BCQ						
bcr	BCR						
bcs	BCS						
bct	BCT						
bcu	BCU						
bcv	BCV						
bcw	BCW						
bcy	BCY						
bcz	BCZ						
bda	BDA						
bdb	BDB						
bdc	BDC						
bdd	BDD						
bde	BDE						
bdf	BDF						
bdg	BDG						
bdh	BDH						
bdi	BDI						
bdj	BDJ						
bdk	BDK						
bdl	BDL						
bdm	BDM						
bdn	BDN						
bdo	BDO						
bdp	BDP						
bdq	BDQ						
bdr	BDR						
bds	BDS						
bdt	BDT						
bdu	BDU						
bdv	BDV						
bdw	BDW						
bdx	BDX						
bdy	BDY						
bdz	BDZ						
bea	BEA						
beb	BEB						
bec	BEC						
bed	BED						
bee	BEE						
bef	BEF						
beg	BEG						
beh	BEH						
bei	BEI						
bej	BEJ	BEJ	bej	BEJ	bej		
bek	BEK						
bel	BEL	BEL	bel	BEL	bel	be	BE
bem	BEM	BEM	bem	BEM	bem		
ben	BEN	BEN	ben	BEN	ben	bn	BN
beo	BEO						
bep	BEP						
beq	BEQ						
bes	BES						
bet	BET						
beu	BEU						
bev	BEV						
bew	BEW						
bex	BEX						
bey	BEY						
bez	BEZ						
bfa	BFA						
bfb	BFB						
bfc	BFC						
bfd	BFD						
bfe	BFE						
bff	BFF						
bfg	BFG						
bfh	BFH						
bfi	BFI						
bfj	BFJ						
bfk	BFK						
bfl	BFL						
bfm	BFM						
bfn	BFN						
bfo	BFO						
bfp	BFP						
bfq	BFQ						
bfr	BFR						
bfs	BFS						
bft	BFT						
bfu	BFU						
bfw	BFW						
bfx	BFX						
bfy	BFY						
bfz	BFZ						
bga	BGA						
bgb	BGB						
bgc	BGC						
bgd	BGD						
bge	BGE						
bgf	BGF						
bgg	BGG						
bgi	BGI						
bgj	BGJ						
bgk	BGK						
bgl	BGL						
bgn	BGN						
bgo	BGO						
bgp	BGP						
bgq	BGQ						
bgr	BGR						
bgs	BGS						
bgt	BGT						
bgu	BGU						
bgv	BGV						
bgw	BGW						
bgx	BGX						
bgy	BGY						
bgz	BGZ						
bha	BHA						
bhb	BHB						
bhc	BHC						
bhd	BHD						
bhe	BHE						
bhf	BHF						
bhg	BHG						
bhh	BHH						
bhi	BHI						
bhj	BHJ						
bhl	BHL						
bhm	BHM						
bhn	BHN						
bho	BHO	BHO	bho	BHO	bho		
bhp	BHP						
bhq	BHQ						
bhr	BHR						
bhs	BHS						
bht	BHT						
bhu	BHU						
bhv	BHV						
bhw	BHW						
bhx	BHX						
bhy	BHY						
bhz	BHZ						
bia	BIA						
bib	BIB						
bic	BIC						
bid	BID						
bie	BIE						
bif	BIF						
big	BIG						
bij	BIJ						
bik	BIK	BIK	bik	BIK	bik		
bil	BIL						
bim	BIM						
bin	BIN	BIN	bin	BIN	bin		
bio	BIO						
bip	BIP						
biq	BIQ						
bir	BIR						
bis	BIS	BIS	bis	BIS	bis	bi	BI
bit	BIT						
biu	BIU						
biv	BIV						
biw	BIW						
bix	BIX						
biy	BIY						
biz	BIZ						
bja	BJA						
bjb	BJB						
bjc	BJC						
bje	BJE						
bjf	BJF						
bjg	BJG						
bjh	BJH						
bji	BJI						
bjj	BJJ						
bjk	BJK						
bjl	BJL						
bjm	BJM						
bjn	BJN						
bjo	BJO						
bjp	BJP						
bjr	BJR						
bjs	BJS						
bjt	BJT						
bju	BJU						
bjv	BJV						
bjw	BJW						
bjx	BJX						
bjy	BJY						
bjz	BJZ						
bka	BKA						
bkc	BKC						
bkd	BKD						
bkf	BKF						
bkg	BKG						
bkh	BKH						
bki	BKI						
bkj	BKJ						
bkk	BKK						
bkl	BKL						
bkm	BKM						
bkn	BKN						
bko	BKO						
bkp	BKP						
bkq	BKQ						
bkr	BKR						
bks	BKS						
bkt	BKT						
bku	BKU						
bkv	BKV						
bkw	BKW						
bkx	BKX						
bky	BKY						
bkz	BKZ						
bla	BLA	BLA	bla	BLA	bla		
blb	BLB						
blc	BLC						
bld	BLD						
ble	BLE						
blf	BLF						
blg	BLG						
blh	BLH						
bli	BLI						
blj	BLJ						
blk	BLK						
bll	BLL						
blm	BLM						
bln	BLN						
blo	BLO						
blp	BLP						
blq	BLQ						
blr	BLR						
bls	BLS						
blt	BLT						
blv	BLV						
blw	BLW						
blx	BLX						
bly	BLY						
blz	BLZ						
bma	BMA						
bmb	BMB						
bmc	BMC						
bmd	BMD						
bme	BME						
bmf	BMF						
bmg	BMG						
bmh	BMH						
bmi	BMI						
bmj	BMJ						
bmk	BMK						
bml	BML						
bmm	BMM						
bmn	BMN						
bmo	BMO						
bmp	BMP						
bmq	BMQ						
bmr	BMR						
bms	BMS						
bmt	BMT						
bmu	BMU						
bmv	BMV						
bmw	BMW						
bmx	BMX						
bmz	BMZ						
bna	BNA						
bnb	BNB						
bnc	BNC						
bnd	BND						
bne	BNE						
bnf	BNF						
bng	BNG						
bni	BNI						
bnj	BNJ						
bnk	BNK						
bnl	BNL						
bnm	BNM						
bnn	BNN						
bno	BNO						
bnp	BNP						
bnq	BNQ						
bnr	BNR						
bns	BNS						
bnu	BNU						
bnv	BNV						
bnw	BNW						
bnx	BNX						
bny	BNY						
bnz	BNZ						
boa	BOA						
bob	BOB						
bod	BOD	TIB	tib	BOD	bod	bo	BO
boe	BOE						
bof	BOF						
bog	BOG						
boh	BOH						
boi	BOI						
boj	BOJ						
bok	BOK						
bol	BOL						
bom	BOM						
bon	BON						
boo	BOO						
bop	BOP						
boq	BOQ						
bor	BOR						
bos	BOS	BOS	bos	BOS	bos	bs	BS
bot	BOT						
bou	BOU						
bov	BOV						
bow	BOW						
box	BOX						
boy	BOY						
boz	BOZ						
bpa	BPA						
bpd	BPD						
bpg	BPG						
bph	BPH						
bpi	BPI						
bpj	BPJ						
bpk	BPK						
bpl	BPL						
bpm	BPM						
bpn	BPN						
bpo	BPO						
bpp	BPP						
bpq	BPQ						
bpr	BPR						
bps	BPS						
bpt	BPT						
bpu	BPU						
bpv	BPV						
bpw	BPW						
bpx	BPX						
bpy	BPY						
bpz	BPZ						
bqa	BQA						
bqb	BQB						
bqc	BQC						
bqd	BQD						
bqf	BQF						
bqg	BQG						
bqh	BQH						
bqi	BQI						
bqj	BQJ						
bqk	BQK						
bql	BQL						
bqm	BQM						
bqn	BQN						
bqo	BQO						
bqp	BQP						
bqq	BQQ						
bqr	BQR						
bqs	BQS						
bqt	BQT						
bqu	BQU						
bqv	BQV						
bqw	BQW						
bqx	BQX						
bqy	BQY						
bqz	BQZ						
bra	BRA	BRA	bra	BRA	bra		
brb	BRB						
brc	BRC						
brd	BRD						
bre	BRE	BRE	bre	BRE	bre	br	BR
brf	BRF						
brg	BRG						
brh	BRH						
bri	BRI						
brj	BRJ						
brk	BRK						
brl	BRL						
brm	BRM						
brn	BRN						
bro	BRO						
brp	BRP						
brq	BRQ						
brr	BRR						
brs	BRS						
brt	BRT						
bru	BRU						
brv	BRV						
brw	BRW						
brx	BRX						
bry	BRY						
brz	BRZ						
bsa	BSA						
bsb	BSB						
bsc	BSC						
bse	BSE						
bsf	BSF						
bsg	BSG						
bsh	BSH						
bsi	BSI						
bsj	BSJ						
bsk	BSK						
bsl	BSL						
bsm	BSM						
bsn	BSN						
bso	BSO						
bsp	BSP						
bsq	BSQ						
bsr	BSR						
bss	BSS						
bst	BST						
bsu	BSU						
bsv	BSV						
bsw	BSW						
bsx	BSX						
bsy	BSY						
bta	BTA						
btc	BTC						
btd	BTD						
bte	BTE						
btf	BTF						
btg	BTG						
bth	BTH						
bti	BTI						
btj	BTJ						
btm	BTM						
btn	BTN						
bto	BTO						
btp	BTP						
btq	BTQ						
btr	BTR						
bts	BTS						
btt	BTT						
btu	BTU						
btv	BTV						
btw	BTW						
btx	BTX						
bty	BTY						
btz	BTZ						
bua	BUA	BUA	bua	BUA	bua		
bub	BUB						
buc	BUC						
bud	BUD						
bue	BUE						
buf	BUF						
bug	BUG	BUG	bug	BUG	bug		
buh	BUH						
bui	BUI						
buj	BUJ						
buk	BUK						
bul	BUL	BUL	bul	BUL	bul	bg	BG
bum	BUM						
bun	BUN						
buo	BUO						
bup	BUP						
buq	BUQ						
bus	BUS						
but	BUT						
buu	BUU						
buv	BUV						
buw	BUW						
bux	BUX						
buy	BUY						
buz	BUZ						
bva	BVA						
bvb	BVB						
bvc	BVC						
bvd	BVD						
bve	BVE						
bvf	BVF						
bvg	BVG						
bvh	BVH						
bvi	BVI						
bvj	BVJ						
bvk	BVK						
bvl	BVL						
bvm	BVM						
bvn	BVN						
bvo	BVO						
bvp	BVP						
bvq	BVQ						
bvr	BVR						
bvt	BVT						
bvu	BVU						
bvv	BVV						
bvw	BVW						
bvx	BVX						
bvy	BVY						
bvz	BVZ						
bwa	BWA						
bwb	BWB						
bwc	BWC						
bwd	BWD						
bwe	BWE						
bwf	BWF						
bwg	BWG						
bwh	BWH						
bwi	BWI						
bwj	BWJ						
bwk	BWK						
bwl	BWL						
bwm	BWM						
bwn	BWN						
bwo	BWO						
bwp	BWP						
bwq	BWQ						
bwr	BWR						
bws	BWS						
bwt	BWT						
bwu	BWU						
bww	BWW						
bwx	BWX						
bwy	BWY						
bwz	BWZ						
bxa	BXA						
bxb	BXB						
bxc	BXC						
bxd	BXD						
bxe	BXE						
bxf	BXF						
bxg	BXG						
bxh	BXH						
bxi	BXI						
bxj	BXJ						
bxk	BXK						
bxl	BXL						
bxm	BXM						
bxn	BXN						
bxo	BXO						
bxp	BXP						
bxq	BXQ						
bxr	BXR						
bxs	BXS						
bxu	BXU						
bxv	BXV						
bxw	BXW						
bxz	BXZ						
bya	BYA						
byb	BYB						
byc	BYC						
byd	BYD						
bye	BYE						
byf	BYF						
byg	BYG						
byh	BYH						
byi	BYI						
byj	BYJ						
byk	BYK						
byl	BYL						
bym	BYM						
byn	BYN	BYN	byn	BYN	byn		
byo	BYO						
byp	BYP						
byq	BYQ						
byr	BYR						
bys	BYS						
byt	BYT						
byv	BYV						
byw	BYW						
byx	BYX						
byz	BYZ						
bza	BZA						
bzb	BZB						
bzc	BZC						
bzd	BZD						
bze	BZE						
bzf	BZF						
bzg	BZG						
bzh	BZH						
bzi	BZI						
bzj	BZJ						
bzk	BZK						
bzl	BZL						
bzm	BZM						
bzn	BZN						
bzo	BZO						
bzp	BZP						
bzq	BZQ						
bzr	BZR						
bzs	BZS						
bzt	BZT						
bzu	BZU						
bzv	BZV						
bzw	BZW						
bzx	BZX						
bzy	BZY						
bzz	BZZ						
caa	CAA						
cab	CAB						
cac	CAC						
cad	CAD	CAD	cad	CAD	cad		
cae	CAE						
caf	CAF						
cag	CAG						
cah	CAH						
caj	CAJ						
cak	CAK						
cal	CAL						
cam	CAM						
can	CAN						
cao	CAO						
cap	CAP						
caq	CAQ						
car	CAR	CAR	car	CAR	car		
cas	CAS						
cat	CAT	CAT	cat	CAT	cat	ca	CA
cav	CAV						
caw	CAW						
cax	CAX						
cay	CAY						
caz	CAZ						
cbb	CBB						
cbc	CBC						
cbd	CBD						
cbg	CBG						
cbi	CBI						
cbj	CBJ						
cbk	CBK						
cbl	CBL						
cbn	CBN						
cbo	CBO						
cbq	CBQ						
cbr	CBR						
cbs	CBS						
cbt	CBT						
cbu	CBU						
cbv	CBV						
cbw	CBW						
cby	CBY						
ccc	CCC						
ccd	CCD						
cce	CCE						
ccg	CCG						
cch	CCH						
ccj	CCJ						
ccl	CCL						
ccm	CCM						
cco	CCO						
ccp	CCP						
ccr	CCR						
cda	CDA						
cde	CDE						
cdf	CDF						
cdh	CDH						
cdi	CDI						
cdj	CDJ						
cdm	CDM						
cdn	CDN						
cdo	CDO						
cdr	CDR						
cds	CDS						
cdy	CDY						
cdz	CDZ						
cea	CEA						
ceb	CEB	CEB	ceb	CEB	ceb		
ceg	CEG						
cek	CEK						
cen	CEN						
ces	CES	CZE	cze	CES	ces	cs	CS
cet	CET						
cey	CEY						
cfa	CFA						
cfd	CFD						
cfg	CFG						
cfm	CFM						
cga	CGA						
cgc	CGC						
cgg	CGG						
cgk	CGK						
cha	CHA	CHA	cha	CHA	cha	ch	CH
chb	CHB	CHB	chb	CHB	chb		
chc	CHC						
chd	CHD						
che	CHE	CHE	che	CHE	che	ce	CE
chf	CHF						
chg	CHG	CHG	chg	CHG	chg		
chh	CHH						
chj	CHJ						
chk	CHK	CHK	chk	CHK	chk		
chl	CHL						
chm	CHM	CHM	chm	CHM	chm		
chn	CHN	CHN	chn	CHN	chn		
cho	CHO	CHO	cho	CHO	cho		
chp	CHP	CHP	chp	CHP	chp		
chq	CHQ						
chr	CHR	CHR	chr	CHR	chr		
cht	CHT						
chu	CHU	CHU	chu	CHU	chu	cu	CU
chv	CHV	CHV	chv	CHV	chv	cv	CV
chw	CHW						
chx	CHX						
chy	CHY	CHY	chy	CHY	chy		
chz	CHZ						
cia	CIA						
cib	CIB						
cic	CIC						
cid	CID						
cie	CIE						
cih	CIH						
cik	CIK						
cim	CIM						
cin	CIN						
cip	CIP						
cir	CIR						
ciw	CIW						
ciy	CIY						
cja	CJA						
cje	CJE						
cjh	CJH						
cji	CJI						
cjk	CJK						
cjm	CJM						
cjn	CJN						
cjo	CJO						
cjp	CJP						
cjs	CJS						
cjv	CJV						
cjy	CJY						
ckb	CKB						
ckh	CKH						
ckl	CKL						
ckm	CKM						
ckn	CKN						
cko	CKO						
ckq	CKQ						
ckr	CKR						
cks	CKS						
ckt	CKT						
cku	CKU						
ckv	CKV						
ckx	CKX						
cky	CKY						
ckz	CKZ						
cla	CLA						
clc	CLC						
cld	CLD						
cle	CLE						
clh	CLH						
cli	CLI						
clj	CLJ						
clk	CLK						
cll	CLL						
clm	CLM						
clo	CLO						
clt	CLT						
clu	CLU						
clw	CLW						
cly	CLY						
cma	CMA						
cme	CME						
cmg	CMG						
cmi	CMI						
cml	CML						
cmm	CMM						
cmn	CMN						
cmo	CMO						
cmr	CMR						
cms	CMS						
cmt	CMT						
cna	CNA						
cnb	CNB						
cnc	CNC						
cng	CNG						
cnh	CNH						
cni	CNI						
cnk	CNK						
cnl	CNL						
cno	CNO						
cnp	CNP						
cnr	CNR	CNR	cnr	CNR	cnr		
cns	CNS						
cnt	CNT						
cnu	CNU						
cnw	CNW						
cnx	CNX						
coa	COA						
cob	COB						
coc	COC						
cod	COD						
coe	COE						
cof	COF						
cog	COG						
coh	COH						
coj	COJ						
cok	COK						
col	COL						
com	COM						
con	CON						
coo	COO						
cop	COP	COP	cop	COP	cop		
coq	COQ						
cor	COR	COR	cor	COR	cor	kw	KW
cos	COS	COS	cos	COS	cos	co	CO
cot	COT						
cou	COU						
cov	COV						
cow	COW						
cox	COX						
coz	COZ						
cpa	CPA						
cpb	CPB						
cpc	CPC						
cpg	CPG						
cpi	CPI						
cpn	CPN						
cpo	CPO						
cps	CPS						
cpu	CPU						
cpx	CPX						
cpy	CPY						
cqd	CQD						
cra	CRA						
crb	CRB						
crc	CRC						
crd	CRD						
cre	CRE	CRE	cre	CRE	cre	cr	CR
crf	CRF						
crg	CRG						
crh	CRH	CRH	crh	CRH	crh		
cri	CRI						
crj	CRJ						
crk	CRK						
crl	CRL						
crm	CRM						
crn	CRN						
cro	CRO						
crq	CRQ						
crr	CRR						
crs	CRS						
crt	CRT						
crv	CRV						
crw	CRW						
crx	CRX						
cry	CRY						
crz	CRZ						
csa	CSA						
csb	CSB	CSB	csb	CSB	csb		
csc	CSC						
csd	CSD						
cse	CSE						
csf	CSF						
csg	CSG						
csh	CSH						
csi	CSI						
csj	CSJ						
csk	CSK						
csl	CSL						
csm	CSM						
csn	CSN						
cso	CSO						
csp	CSP						
csq	CSQ						
csr	CSR						
css	CSS						
cst	CST						
csv	CSV						
csw	CSW						
csy	CSY						
csz	CSZ						
cta	CTA						
ctc	CTC						
ctd	CTD						
cte	CTE						
ctg	CTG						
cth	CTH						
ctl	CTL						
ctm	CTM						
ctn	CTN						
cto	CTO						
ctp	CTP						
cts	CTS						
ctt	CTT						
ctu	CTU						
ctz	CTZ						
cua	CUA						
cub	CUB						
cuc	CUC						
cug	CUG						
cuh	CUH						
cui	CUI						
cuj	CUJ						
cuk	CUK						
cul	CUL						
cuo	CUO						
cup	CUP						
cuq	CUQ						
cur	CUR						
cut	CUT						
cuu	CUU						
cuv	CUV						
cuw	CUW						
cux	CUX						
cuy	CUY						
cvg	CVG						
cvn	CVN						
cwa	CWA						
cwb	CWB						
cwd	CWD						
cwe	CWE						
cwg	CWG						
cwt	CWT						
cya	CYA						
cyb	CYB						
cym	CYM	WEL	wel	CYM	cym	cy	CY
cyo	CYO						
czh	CZH						
czk	CZK						
czn	CZN						
czo	CZO						
czt	CZT						
daa	DAA						
dac	DAC						
dad	DAD						
dae	DAE						
dag	DAG						
dah	DAH						
dai	DAI						
daj	DAJ						
dak	DAK	DAK	dak	DAK	dak		
dal	DAL						
dam	DAM						
dan	DAN	DAN	dan	DAN	dan	da	DA
dao	DAO						
daq	DAQ						
dar	DAR	DAR	dar	DAR	dar		
das	DAS						
dau	DAU						
dav	DAV						
daw	DAW						
dax	DAX						
daz	DAZ						
dba	DBA						
dbb	DBB						
dbd	DBD						
dbe	DBE						
dbf	DBF						
dbg	DBG						
dbi	DBI						
dbj	DBJ						
dbl	DBL						
dbm	DBM						
dbn	DBN						
dbo	DBO						
dbp	DBP						
dbq	DBQ						
dbr	DBR						
dbt	DBT						
dbu	DBU						
dbv	DBV						
dbw	DBW						
dby	DBY						
dcc	DCC						
dcr	DCR						
dda	DDA						
ddd	DDD						
dde	DDE						
ddg	DDG						
ddi	DDI						
ddj	DDJ						
ddn	DDN						
ddo	DDO						
ddr	DDR						
dds	DDS						
ddw	DDW						
dec	DEC						
ded	DED						
dee	DEE						
def	DEF						
deg	DEG						
deh	DEH						
dei	DEI						
dek	DEK						
del	DEL	DEL	del	DEL	del		
dem	DEM						
den	DEN	DEN	den	DEN	den		
dep	DEP						
deq	DEQ						
der	DER						
des	DES						
deu	DEU	GER	ger	DEU	deu	de	DE
dev	DEV						
dez	DEZ						
dga	DGA						
dgb	DGB						
dgc	DGC						
dgd	DGD						
dge	DGE						
dgg	DGG						
dgh	DGH						
dgi	DGI						
dgk	DGK						
dgl	DGL						
dgn	DGN						
dgo	DGO						
dgr	DGR	DGR	dgr	DGR	dgr		
dgs	DGS						
dgt	DGT						
dgw	DGW						
dgx	DGX						
dgz	DGZ						
dhd	DHD						
dhg	DHG						
dhi	DHI						
dhl	DHL						
dhm	DHM						
dhn	DHN						
dho	DHO						
dhr	DHR						
dhs	DHS						
dhu	DHU						
dhv	DHV						
dhw	DHW						
dhx	DHX						
dia	DIA						
dib	DIB						
dic	DIC						
did	DID						
dif	DIF						
dig	DIG						
dih	DIH						
dii	DII						
dij	DIJ						
dik	DIK						
dil	DIL						
dim	DIM						
din	DIN	DIN	din	DIN	din		
dio	DIO						
dip	DIP						
diq	DIQ						
dir	DIR						
dis	DIS						
diu	DIU						
div	DIV	DIV	div	DIV	div	dv	DV
diw	DIW						
dix	DIX						
diy	DIY						
diz	DIZ						
dja	DJA						
djb	DJB						
djc	DJC						
djd	DJD						
dje	DJE						
djf	DJF						
dji	DJI						
djj	DJJ						
djk	DJK						
djm	DJM						
djn	DJN						
djo	DJO						
djr	DJR						
dju	DJU						
djw	DJW						
dka	DKA						
dkk	DKK						
dkr	DKR						
dks	DKS						
dkx	DKX						
dlg	DLG						
dlk	DLK						
dlm	DLM						
dln	DLN						
dma	DMA						
dmb	DMB						
dmc	DMC						
dmd	DMD						
dme	DME						
dmf	DMF						
dmg	DMG						
dmk	DMK						
dml	DML						
dmm	DMM						
dmo	DMO						
dmr	DMR						
dms	DMS						
dmu	DMU						
dmv	DMV						
dmw	DMW						
dmx	DMX						
dmy	DMY						
dna	DNA						
dnd	DND						
dne	DNE						
dng	DNG						
dni	DNI						
dnj	DNJ						
dnk	DNK						
dnn	DNN						
dno	DNO						
dnr	DNR						
dnt	DNT						
dnu	DNU						
dnv	DNV						
dnw	DNW						
dny	DNY						
doa	DOA						
dob	DOB						
doc	DOC						
doe	DOE						
dof	DOF						
doh	DOH						
doi	DOI	DOI	doi	DOI	doi		
dok	DOK						
dol	DOL						
don	DON						
doo	DOO						
dop	DOP						
doq	DOQ						
dor	DOR						
dos	DOS						
dot	DOT						
dov	DOV						
dow	DOW						
dox	DOX						
doy	DOY						
doz	DOZ						
dpp	DPP						
drb	DRB						
drc	DRC						
drd	DRD						
dre	DRE						
drg	DRG						
dri	DRI						
drl	DRL						
drn	DRN						
dro	DRO						
drq	DRQ						
drs	DRS						
drt	DRT						
dru	DRU						
dry	DRY						
dsb	DSB	DSB	dsb	DSB	dsb		
dse	DSE						
dsh	DSH						
dsi	DSI						
dsl	DSL						
dsn	DSN						
dso	DSO						
dsq	DSQ						
dta	DTA						
dtb	DTB						
dtd	DTD						
dth	DTH						
dti	DTI						
dtk	DTK						
dtm	DTM						
dtn	DTN						
dto	DTO						
dtp	DTP						
dtr	DTR						
dts	DTS						
dtt	DTT						
dtu	DTU						
dty	DTY						
dua	DUA	DUA	dua	DUA	dua		
dub	DUB						
duc	DUC						
due	DUE						
duf	DUF						
dug	DUG						
duh	DUH						
dui	DUI						
duk	DUK						
dul	DUL						
dum	DUM	DUM	dum	DUM	dum		
dun	DUN						
duo	DUO						
dup	DUP						
duq	DUQ						
dur	DUR						
dus	DUS						
duu	DUU						
duv	DUV						
duw	DUW						
dux	DUX						
duy	DUY						
duz	DUZ						
dva	DVA						
dwa	DWA						
dwk	DWK						
dwr	DWR						
dws	DWS						
dwu	DWU						
dww	DWW						
dwy	DWY						
dwz	DWZ						
dya	DYA						
dyb	DYB						
dyd	DYD						
dyg	DYG						
dyi	DYI						
dym	DYM						
dyn	DYN						
dyo	DYO						
dyu	DYU	DYU	dyu	DYU	dyu		
dyy	DYY						
dza	DZA						
dze	DZE						
dzg	DZG						
dzl	DZL						
dzn	DZN						
dzo	DZO	DZO	dzo	DZO	dzo	dz	DZ
eaa	EAA						
ebc	EBC						
ebg	EBG						
ebk	EBK						
ebo	EBO						
ebr	EBR						
ebu	EBU						
ecr	ECR						
ecs	ECS						
ecy	ECY						
eee	EEE						
efa	EFA						
efe	EFE						
efi	EFI	EFI	efi	EFI	efi		
ega	EGA						
egl	EGL						
ego	EGO						
egy	EGY	EGY	egy	EGY	egy		
ehu	EHU						
eip	EIP						
eit	EIT						
eiv	EIV						
eja	EJA						
eka	EKA	EKA	eka	EKA	eka		
eke	EKE						
ekg	EKG						
eki	EKI						
ekk	EKK						
ekl	EKL						
ekm	EKM						
eko	EKO						
ekp	EKP						
ekr	EKR						
eky	EKY						
ele	ELE						
elh	ELH						
eli	ELI						
elk	ELK						
ell	ELL	GRE	gre	ELL	ell	el	EL
elm	ELM						
elo	ELO						
elu	ELU						
elx	ELX	ELX	elx	ELX	elx		
ema	EMA						
emb	EMB						
eme	EME						
emg	EMG						
emi	EMI						
emk	EMK						
emm	EMM						
emn	EMN						
emp	EMP						
ems	EMS						
emu	EMU						
emw	EMW						
emx	EMX						
emy	EMY						
ena	ENA						
enb	ENB						
enc	ENC						
end	END						
enf	ENF						
eng	ENG	ENG	eng	ENG	eng	en	EN
enh	ENH						
enl	ENL						
enm	ENM	ENM	enm	ENM	enm		
enn	ENN						
eno	ENO						
enq	ENQ						
enr	ENR						
enu	ENU						
env	ENV						
enw	ENW						
enx	ENX						
eot	EOT						
epi	EPI						
epo	EPO	EPO	epo	EPO	epo	eo	EO
era	ERA						
erg	ERG						
erh	ERH						
eri	ERI						
erk	ERK						
ero	ERO						
err	ERR						
ers	ERS						
ert	ERT						
erw	ERW						
ese	ESE						
esg	ESG						
esh	ESH						
esi	ESI						
esk	ESK						
esl	ESL						
esm	ESM						
esn	ESN						
eso	ESO						
esq	ESQ						
ess	ESS						
est	EST	EST	est	EST	est	et	ET
esu	ESU						
esy	ESY						
etb	ETB						
etc	ETC						
eth	ETH						
etn	ETN						
eto	ETO						
etr	ETR						
ets	ETS						
ett	ETT						
etu	ETU						
etx	ETX						
etz	ETZ						
eus	EUS	BAQ	baq	EUS	eus	eu	EU
eve	EVE						
evh	EVH						
evn	EVN						
ewe	EWE	EWE	ewe	EWE	ewe	ee	EE
ewo	EWO	EWO	ewo	EWO	ewo		
ext	EXT						
eya	EYA						
eyo	EYO						
eza	EZA						
eze	EZE						
faa	FAA						
fab	FAB						
fad	FAD						
faf	FAF						
fag	FAG						
fah	FAH						
fai	FAI						
faj	FAJ						
fak	FAK						
fal	FAL						
fam	FAM						
fan	FAN	FAN	fan	FAN	fan		
fao	FAO	FAO	fao	FAO	fao	fo	FO
fap	FAP						
far	FAR						
fas	FAS	PER	per	FAS	fas	fa	FA
fat	FAT	FAT	fat	FAT	fat		
fau	FAU						
fax	FAX						
fay	FAY						
faz	FAZ						
fbl	FBL						
fcs	FCS						
fer	FER						
ffi	FFI						
ffm	FFM						
fgr	FGR						
fia	FIA						
fie	FIE						
fif	FIF						
fij	FIJ	FIJ	fij	FIJ	fij	fj	FJ
fil	FIL	FIL	fil	FIL	fil		
fin	FIN	FIN	fin	FIN	fin	fi	FI
fip	FIP						
fir	FIR						
fit	FIT						
fiw	FIW						
fkk	FKK						
fkv	FKV						
fla	FLA						
flh	FLH						
fli	FLI						
fll	FLL						
fln	FLN						
flr	FLR						
fly	FLY						
fmp	FMP						
fmu	FMU						
fnb	FNB						
fng	FNG						
fni	FNI						
fod	FOD						
foi	FOI						
fom	FOM						
fon	FON	FON	fon	FON	fon		
for	FOR						
fos	FOS						
fpe	FPE						
fqs	FQS						
fra	FRA	FRE	fre	FRA	fra	fr	FR
frc	FRC						
frd	FRD						
frk	FRK						
frm	FRM	FRM	frm	FRM	frm		
fro	FRO	FRO	fro	FRO	fro		
frp	FRP						
frq	FRQ						
frr	FRR	FRR	frr	FRR	frr		
frs	FRS	FRS	frs	FRS	frs		
frt	FRT						
fry	FRY	FRY	fry	FRY	fry	fy	FY
fse	FSE						
fsl	FSL						
fss	FSS						
fub	FUB						
fuc	FUC						
fud	FUD						
fue	FUE						
fuf	FUF						
fuh	FUH						
fui	FUI						
fuj	FUJ						
ful	FUL	FUL	ful	FUL	ful	ff	FF
fum	FUM						
fun	FUN						
fuq	FUQ						
fur	FUR	FUR	fur	FUR	fur		
fut	FUT						
fuu	FUU						
fuv	FUV						
fuy	FUY						
fvr	FVR						
fwa	FWA						
fwe	FWE						
gaa	GAA	GAA	gaa	GAA	gaa		
gab	GAB						
gac	GAC						
gad	GAD						
gae	GAE						
gaf	GAF						
gag	GAG						
gah	GAH						
gai	GAI						
gaj	GAJ						
gak	GAK						
gal	GAL						
gam	GAM						
gan	GAN						
gao	GAO						
gap	GAP						
gaq	GAQ						
gar	GAR						
gas	GAS						
gat	GAT						
gau	GAU						
gaw	GAW						
gax	GAX						
gay	GAY	GAY	gay	GAY	gay		
gaz	GAZ						
gba	GBA	GBA	gba	GBA	gba		
gbb	GBB						
gbd	GBD						
gbe	GBE						
gbf	GBF						
gbg	GBG						
gbh	GBH						
gbi	GBI						
gbj	GBJ						
gbk	GBK						
gbl	GBL						
gbm	GBM						
gbn	GBN						
gbo	GBO						
gbp	GBP						
gbq	GBQ						
gbr	GBR						
gbs	GBS						
gbu	GBU						
gbv	GBV						
gbw	GBW						
gbx	GBX						
gby	GBY						
gbz	GBZ						
gcc	GCC						
gcd	GCD						
gce	GCE						
gcf	GCF						
gcl	GCL						
gcn	GCN						
gcr	GCR						
gct	GCT						
gda	GDA						
gdb	GDB						
gdc	GDC						
gdd	GDD						
gde	GDE						
gdf	GDF						
gdg	GDG						
gdh	GDH						
gdi	GDI						
gdj	GDJ						
gdk	GDK						
gdl	GDL						
gdm	GDM						
gdn	GDN						
gdo	GDO						
gdq	GDQ						
gdr	GDR						
gds	GDS						
gdt	GDT						
gdu	GDU						
gdx	GDX						
gea	GEA						
geb	GEB						
gec	GEC						
ged	GED						
gef	GEF						
geg	GEG						
geh	GEH						
gei	GEI						
gej	GEJ						
gek	GEK						
gel	GEL						
geq	GEQ						
ges	GES						
gev	GEV						
gew	GEW						
gex	GEX						
gey	GEY						
gez	GEZ	GEZ	gez	GEZ	gez		
gfk	GFK						
gft	GFT						
gga	GGA						
ggb	GGB						
ggd	GGD						
gge	GGE						
ggg	GGG						
ggk	GGK						
ggl	GGL						
ggt	GGT						
ggu	GGU						
ggw	GGW						
gha	GHA						
ghc	GHC						
ghe	GHE						
ghh	GHH						
ghk	GHK						
ghl	GHL						
ghn	GHN						
gho	GHO						
ghr	GHR						
ghs	GHS						
ght	GHT						
gia	GIA						
gib	GIB						
gic	GIC						
gid	GID						
gie	GIE						
gig	GIG						
gih	GIH						
gil	GIL	GIL	gil	GIL	gil		
gim	GIM						
gin	GIN						
gip	GIP						
giq	GIQ						
gir	GIR						
gis	GIS						
git	GIT						
giu	GIU						
giw	GIW						
gix	GIX						
giy	GIY						
giz	GIZ						
gji	GJI						
gjk	GJK						
gjm	GJM						
gjn	GJN						
gjr	GJR						
gju	GJU						
gka	GKA						
gkd	GKD						
gke	GKE						
gkn	GKN						
gko	GKO						
gkp	GKP						
gku	GKU						
gla	GLA	GLA	gla	GLA	gla	gd	GD
glc	GLC						
gld	GLD						
gle	GLE	GLE	gle	GLE	gle	ga	GA
glg	GLG	GLG	glg	GLG	glg	gl	GL
glh	GLH						
glj	GLJ						
glk	GLK						
gll	GLL						
glo	GLO						
glr	GLR						
glu	GLU						
glv	GLV	GLV	glv	GLV	glv	gv	GV
glw	GLW						
gly	GLY						
gma	GMA						
gmb	GMB						
gmd	GMD						
gmg	GMG						
gmh	GMH	GMH	gmh	GMH	gmh		
gml	GML						
gmm	GMM						
gmn	GMN						
gmr	GMR						
gmu	GMU						
gmv	GMV						
gmx	GMX						
gmy	GMY						
gmz	GMZ						
gna	GNA						
gnb	GNB						
gnc	GNC						
gnd	GND						
gne	GNE						
gng	GNG						
gnh	GNH						
gni	GNI						
gnj	GNJ						
gnk	GNK						
gnl	GNL						
gnm	GNM						
gnn	GNN						
gno	GNO						
gnq	GNQ						
gnr	GNR						
gnt	GNT						
gnu	GNU						
gnw	GNW						
gnz	GNZ						
goa	GOA						
gob	GOB						
goc	GOC						
god	GOD						
goe	GOE						
gof	GOF						
gog	GOG						
goh	GOH	GOH	goh	GOH	goh		
goi	GOI						
goj	GOJ						
gok	GOK						
gol	GOL						
gom	GOM						
gon	GON	GON	gon	GON	gon		
goo	GOO						
gop	GOP						
goq	GOQ						
gor	GOR	GOR	gor	GOR	gor		
gos	GOS						
got	GOT	GOT	got	GOT	got		
gou	GOU						
gow	GOW						
gox	GOX						
goy	GOY						
goz	GOZ						
gpa	GPA						
gpe	GPE						
gpn	GPN						
gqa	GQA						
gqi	GQI						
gqn	GQN						
gqr	GQR						
gqu	GQU						
gra	GRA						
grb	GRB	GRB	grb	GRB	grb		
grc	GRC	GRC	grc	GRC	grc		
grd	GRD						
grg	GRG						
grh	GRH						
gri	GRI						
grj	GRJ						
grm	GRM						
grn	GRN	GRN	grn	GRN	grn	gn	GN
gro	GRO						
grq	GRQ						
grr	GRR						
grs	GRS						
grt	GRT						
gru	GRU						
grv	GRV						
grw	GRW						
grx	GRX						
gry	GRY						
grz	GRZ						
gse	GSE						
gsg	GSG						
gsl	GSL						
gsm	GSM						
gsn	GSN						
gso	GSO						
gsp	GSP						
gss	GSS						
gsw	GSW	GSW	gsw	GSW	gsw		
gta	GTA						
gtu	GTU						
gua	GUA						
gub	GUB						
guc	GUC						
gud	GUD						
gue	GUE						
guf	GUF						
gug	GUG						
guh	GUH						
gui	GUI						
guj	GUJ	GUJ	guj	GUJ	guj	gu	GU
guk	GUK						
gul	GUL						
gum	GUM						
gun	GUN						
guo	GUO						
gup	GUP						
guq	GUQ						
gur	GUR						
gus	GUS						
gut	GUT						
guu	GUU						
guw	GUW						
gux	GUX						
guz	GUZ						
gva	GVA						
gvc	GVC						
gve	GVE						
gvf	GVF						
gvj	GVJ						
gvl	GVL						
gvm	GVM						
gvn	GVN						
gvo	GVO						
gvp	GVP						
gvr	GVR						
gvs	GVS						
gvy	GVY						
gwa	GWA						
gwb	GWB						
gwc	GWC						
gwd	GWD						
gwe	GWE						
gwf	GWF						
gwg	GWG						
gwi	GWI	GWI	gwi	GWI	gwi		
gwj	GWJ						
gwm	GWM						
gwn	GWN						
gwr	GWR						
gwt	GWT						
gwu	GWU						
gww	GWW						
gwx	GWX						
gxx	GXX						
gya	GYA						
gyb	GYB						
gyd	GYD						
gye	GYE						
gyf	GYF						
gyg	GYG						
gyi	GYI						
gyl	GYL						
gym	GYM						
gyn	GYN						
gyo	GYO						
gyr	GYR						
gyy	GYY						
gza	GZA						
gzi	GZI						
gzn	GZN						
haa	HAA						
hab	HAB						
hac	HAC						
had	HAD						
hae	HAE						
haf	HAF						
hag	HAG						
hah	HAH						
hai	HAI	HAI	hai	HAI	hai		
haj	HAJ						
hak	HAK						
hal	HAL						
ham	HAM						
han	HAN						
hao	HAO						
hap	HAP						
haq	HAQ						
har	HAR						
has	HAS						
hat	HAT	HAT	hat	HAT	hat	ht	HT
hau	HAU	HAU	hau	HAU	hau	ha	HA
hav	HAV						
haw	HAW	HAW	haw	HAW	haw		
hax	HAX						
hay	HAY						
haz	HAZ						
hba	HBA						
hbb	HBB						
hbn	HBN						
hbo	HBO						
hbs	HBS					sh	SH
hbu	HBU						
hca	HCA						
hch	HCH						
hdn	HDN						
hds	HDS						
hdy	HDY						
hea	HEA						
heb	HEB	HEB	heb	HEB	heb	he	HE
hed	HED						
heg	HEG						
heh	HEH						
hei	HEI						
hem	HEM						
her	HER	HER	her	HER	her	hz	HZ
hgm	HGM						
hgw	HGW						
hhi	HHI						
hhr	HHR						
hhy	HHY						
hia	HIA						
hib	HIB						
hid	HID						
hif	HIF						
hig	HIG						
hih	HIH						
hii	HII						
hij	HIJ						
hik	HIK						
hil	HIL	HIL	hil	HIL	hil		
hin	HIN	HIN	hin	HIN	hin	hi	HI
hio	HIO						
hir	HIR						
hit	HIT	HIT	hit	HIT	hit		
hiw	HIW						
hix	HIX						
hji	HJI						
hka	HKA						
hke	HKE						
hkk	HKK						
hkn	HKN						
hks	HKS						
hla	HLA						
hlb	HLB						
hld	HLD						
hle	HLE						
hlt	HLT						
hlu	HLU						
hma	HMA						
hmb	HMB						
hmc	HMC						
hmd	HMD						
hme	HME						
hmf	HMF						
hmg	HMG						
hmh	HMH						
hmi	HMI						
hmj	HMJ						
hmk	HMK						
hml	HML						
hmm	HMM						
hmn	HMN	HMN	hmn	HMN	hmn		
hmo	HMO	HMO	hmo	HMO	hmo	ho	HO
hmp	HMP						
hmq	HMQ						
hmr	HMR						
hms	HMS						
hmt	HMT						
hmu	HMU						
hmv	HMV						
hmw	HMW						
hmy	HMY						
hmz	HMZ						
hna	HNA						
hnd	HND						
hne	HNE						
hng	HNG						
hnh	HNH						
hni	HNI						
hnj	HNJ						
hnn	HNN						
hno	HNO						
hns	HNS						
hnu	HNU						
hoa	HOA						
hob	HOB						
hoc	HOC						
hod	HOD						
hoe	HOE						
hoh	HOH						
hoi	HOI						
hoj	HOJ						
hol	HOL						
hom	HOM						
hoo	HOO						
hop	HOP						
hor	HOR						
hos	HOS						
hot	HOT						
hov	HOV						
how	HOW						
hoy	HOY						
hoz	HOZ						
hpo	HPO						
hps	HPS						
hra	HRA						
hrc	HRC						
hre	HRE						
hrk	HRK						
hrm	HRM						
hro	HRO						
hrp	HRP						
hrt	HRT						
hru	HRU						
hrv	HRV	HRV	hrv	HRV	hrv	hr	HR
hrw	HRW						
hrx	HRX						
hrz	HRZ						
hsb	HSB	HSB	hsb	HSB	hsb		
hsh	HSH						
hsl	HSL						
hsn	HSN						
hss	HSS						
hti	HTI						
hto	HTO						
hts	HTS						
htu	HTU						
htx	HTX						
hub	HUB						
huc	HUC						
hud	HUD						
hue	HUE						
huf	HUF						
hug	HUG						
huh	HUH						
hui	HUI						
huj	HUJ						
huk	HUK						
hul	HUL						
hum	HUM						
hun	HUN	HUN	hun	HUN	hun	hu	HU
huo	HUO						
hup	HUP	HUP	hup	HUP	hup		
huq	HUQ						
hur	HUR						
hus	HUS						
hut	HUT						
huu	HUU						
huv	HUV						
huw	HUW						
hux	HUX						
huy	HUY						
huz	HUZ						
hvc	HVC						
hve	HVE						
hvk	HVK						
hvn	HVN						
hvv	HVV						
hwa	HWA						
hwc	HWC						
hwo	HWO						
hya	HYA						
hye	HYE	ARM	arm	HYE	hye	hy	HY
hyw	HYW						
iai	IAI						
ian	IAN						
iar	IAR						
iba	IBA	IBA	iba	IBA	iba		
ibb	IBB						
ibd	IBD						
ibe	IBE						
ibg	IBG						
ibh	IBH						
ibl	IBL						
ibm	IBM						
ibn	IBN						
ibo	IBO	IBO	ibo	IBO	ibo	ig	IG
ibr	IBR						
ibu	IBU						
iby	IBY						
ica	ICA						
ich	ICH						
icl	ICL						
icr	ICR						
ida	IDA						
idb	IDB						
idc	IDC						
idd	IDD						
ide	IDE						
idi	IDI						
ido	IDO	IDO	ido	IDO	ido	io	IO
idr	IDR						
ids	IDS						
idt	IDT						
idu	IDU						
ifa	IFA						
ifb	IFB						
ife	IFE						
iff	IFF						
ifk	IFK						
ifm	IFM						
ifu	IFU						
ify	IFY						
igb	IGB						
ige	IGE						
igg	IGG						
igl	IGL						
igm	IGM						
ign	IGN						
igo	IGO						
igs	IGS						
igw	IGW						
ihb	IHB						
ihi	IHI						
ihp	IHP						
ihw	IHW						
iii	III	III	iii	III	iii	ii	II
iin	IIN						
ijc	IJC						
ije	IJE						
ijj	IJJ						
ijn	IJN						
ijs	IJS						
ike	IKE						
iki	IKI						
ikk	IKK						
ikl	IKL						
iko	IKO						
ikp	IKP						
ikr	IKR						
iks	IKS						
ikt	IKT						
iku	IKU	IKU	iku	IKU	iku	iu	IU
ikv	IKV						
ikw	IKW						
ikx	IKX						
ikz	IKZ						
ila	ILA						
ilb	ILB						
ile	ILE	ILE	ile	ILE	ile	ie	IE
ilg	ILG						
ili	ILI						
ilk	ILK						
ilm	ILM						
ilo	ILO	ILO	ilo	ILO	ilo		
ilp	ILP						
ils	ILS						
ilu	ILU						
ilv	ILV						
ima	IMA						
imi	IMI						
iml	IML						
imn	IMN						
imo	IMO						
imr	IMR						
ims	IMS						
imy	IMY						
ina	INA	INA	ina	INA	ina	ia	IA
inb	INB						
ind	IND	IND	ind	IND	ind	id	ID
ing	ING						
inh	INH	INH	inh	INH	inh		
inj	INJ						
inl	INL						
inm	INM						
inn	INN						
ino	INO						
inp	INP						
ins	INS						
int	INT						
inz	INZ						
ior	IOR						
iou	IOU						
iow	IOW						
ipi	IPI						
ipk	IPK	IPK	ipk	IPK	ipk	ik	IK
ipo	IPO						
iqu	IQU						
iqw	IQW						
ire	IRE						
irh	IRH						
iri	IRI						
irk	IRK						
irn	IRN						
irr	IRR						
iru	IRU						
irx	IRX						
iry	IRY						
isa	ISA						
isc	ISC						
isd	ISD						
ise	ISE						
isg	ISG						
ish	ISH						
isi	ISI						
isk	ISK						
isl	ISL	ICE	ice	ISL	isl	is	IS
ism	ISM						
isn	ISN						
iso	ISO						
isr	ISR						
ist	IST						
isu	ISU						
ita	ITA	ITA	ita	ITA	ita	it	IT
itb	ITB						
itd	ITD						
ite	ITE						
iti	ITI						
itk	ITK						
itl	ITL						
itm	ITM						
ito	ITO						
itr	ITR						
its	ITS						
itt	ITT						
itv	ITV						
itw	ITW						
itx	ITX						
ity	ITY						
itz	ITZ						
ium	IUM						
ivb	IVB						
ivv	IVV						
iwk	IWK						
iwm	IWM						
iwo	IWO						
iws	IWS						
ixc	IXC						
ixl	IXL						
iya	IYA						
iyo	IYO						
iyx	IYX						
izh	IZH						
izr	IZR						
izz	IZZ						
jaa	JAA						
jab	JAB						
jac	JAC						
jad	JAD						
jae	JAE						
jaf	JAF						
jah	JAH						
jaj	JAJ						
jak	JAK						
jal	JAL						
jam	JAM						
jan	JAN						
jao	JAO						
jaq	JAQ						
jas	JAS						
jat	JAT						
jau	JAU						
jav	JAV	JAV	jav	JAV	jav	jv	JV
jax	JAX						
jay	JAY						
jaz	JAZ						
jbe	JBE						
jbi	JBI						
jbj	JBJ						
jbk	JBK						
jbn	JBN						
jbo	JBO	JBO	jbo	JBO	jbo		
jbr	JBR						
jbt	JBT						
jbu	JBU						
jbw	JBW						
jcs	JCS						
jct	JCT						
jda	JDA						
jdg	JDG						
jdt	JDT						
jeb	JEB						
jee	JEE						
jeh	JEH						
jei	JEI						
jek	JEK						
jel	JEL						
jen	JEN						
jer	JER						
jet	JET						
jeu	JEU						
jgb	JGB						
jge	JGE						
jgk	JGK						
jgo	JGO						
jhi	JHI						
jhs	JHS						
jia	JIA						
jib	JIB						
jic	JIC						
jid	JID						
jie	JIE						
jig	JIG						
jih	JIH						
jii	JII						
jil	JIL						
jim	JIM						
jio	JIO						
jiq	JIQ						
jit	JIT						
jiu	JIU						
jiv	JIV						
jiy	JIY						
jje	JJE						
jjr	JJR						
jka	JKA						
jkm	JKM						
jko	JKO						
jkp	JKP						
jkr	JKR						
jku	JKU						
jle	JLE						
jls	JLS						
jma	JMA						
jmb	JMB						
jmc	JMC						
jmd	JMD						
jmi	JMI						
jml	JML						
jmn	JMN						
jmr	JMR						
jms	JMS						
jmw	JMW						
jmx	JMX						
jna	JNA						
jnd	JND						
jng	JNG						
jni	JNI						
jnj	JNJ						
jnl	JNL						
jns	JNS						
job	JOB						
jod	JOD						
jog	JOG						
jor	JOR						
jos	JOS						
jow	JOW						
jpa	JPA						
jpn	JPN	JPN	jpn	JPN	jpn	ja	JA
jpr	JPR	JPR	jpr	JPR	jpr		
jqr	JQR						
jra	JRA						
jrb	JRB	JRB	jrb	JRB	jrb		
jrt	JRT						
jru	JRU						
jsl	JSL						
jua	JUA						
jub	JUB						
juc	JUC						
jud	JUD						
juh	JUH						
jui	JUI						
juk	JUK						
jul	JUL						
jum	JUM						
jun	JUN						
juo	JUO						
jup	JUP						
jur	JUR						
jus	JUS						
jut	JUT						
juu	JUU						
juw	JUW						
juy	JUY						
jvd	JVD						
jvn	JVN						
jwi	JWI						
jya	JYA						
jye	JYE						
jyy	JYY						
kaa	KAA	KAA	kaa	KAA	kaa		
kab	KAB	KAB	kab	KAB	kab		
kac	KAC	KAC	kac	KAC	kac		
kad	KAD						
kae	KAE						
kaf	KAF						
kag	KAG						
kah	KAH						
kai	KAI						
kaj	KAJ						
kak	KAK						
kal	KAL	KAL	kal	KAL	kal	kl	KL
kam	KAM	KAM	kam	KAM	kam		
kan	KAN	KAN	kan	KAN	kan	kn	KN
kao	KAO						
kap	KAP						
kaq	KAQ						
kas	KAS	KAS	kas	KAS	kas	ks	KS
kat	KAT	GEO	geo	KAT	kat	ka	KA
kau	KAU	KAU	kau	KAU	kau	kr	KR
kav	KAV						
kaw	KAW	KAW	kaw	KAW	kaw		
kax	KAX						
kay	KAY						
kaz	KAZ	KAZ	kaz	KAZ	kaz	kk	KK
kba	KBA						
kbb	KBB						
kbc	KBC						
kbd	KBD	KBD	kbd	KBD	kbd		
kbe	KBE						
kbg	KBG						
kbh	KBH						
kbi	KBI						
kbj	KBJ						
kbk	KBK						
kbl	KBL						
kbm	KBM						
kbn	KBN						
kbo	KBO						
kbp	KBP						
kbq	KBQ						
kbr	KBR						
kbs	KBS						
kbt	KBT						
kbu	KBU						
kbv	KBV						
kbw	KBW						
kbx	KBX						
kby	KBY						
kbz	KBZ						
kca	KCA						
kcb	KCB						
kcc	KCC						
kcd	KCD						
kce	KCE						
kcf	KCF						
kcg	KCG						
kch	KCH						
kci	KCI						
kcj	KCJ						
kck	KCK						
kcl	KCL						
kcm	KCM						
kcn	KCN						
kco	KCO						
kcp	KCP						
kcq	KCQ						
kcr	KCR						
kcs	KCS						
kct	KCT						
kcu	KCU						
kcv	KCV						
kcw	KCW						
kcx	KCX						
kcy	KCY						
kcz	KCZ						
kda	KDA						
kdc	KDC						
kdd	KDD						
kde	KDE						
kdf	KDF						
kdg	KDG						
kdh	KDH						
kdi	KDI						
kdj	KDJ						
kdk	KDK						
kdl	KDL						
kdm	KDM						
kdn	KDN						
kdp	KDP						
kdq	KDQ						
kdr	KDR						
kdt	KDT						
kdu	KDU						
kdw	KDW						
kdx	KDX						
kdy	KDY						
kdz	KDZ						
kea	KEA						
keb	KEB						
kec	KEC						
ked	KED						
kee	KEE						
kef	KEF						
keg	KEG						
keh	KEH						
kei	KEI						
kej	KEJ						
kek	KEK						
kel	KEL						
kem	KEM						
ken	KEN						
keo	KEO						
kep	KEP						
keq	KEQ						
ker	KER						
kes	KES						
ket	KET						
keu	KEU						
kev	KEV						
kew	KEW						
kex	KEX						
key	KEY						
kez	KEZ						
kfa	KFA						
kfb	KFB						
kfc	KFC						
kfd	KFD						
kfe	KFE						
kff	KFF						
kfg	KFG						
kfh	KFH						
kfi	KFI						
kfj	KFJ						
kfk	KFK						
kfl	KFL						
kfm	KFM						
kfn	KFN						
kfo	KFO						
kfp	KFP						
kfq	KFQ						
kfr	KFR						
kfs	KFS						
kft	KFT						
kfu	KFU						
kfv	KFV						
kfw	KFW						
kfx	KFX						
kfy	KFY						
kfz	KFZ						
kga	KGA						
kgb	KGB						
kge	KGE						
kgf	KGF						
kgg	KGG						
kgi	KGI						
kgj	KGJ						
kgk	KGK						
kgl	KGL						
kgm	KGM						
kgn	KGN						
kgo	KGO						
kgp	KGP						
kgq	KGQ						
kgr	KGR						
kgs	KGS						
kgt	KGT						
kgu	KGU						
kgv	KGV						
kgw	KGW						
kgx	KGX						
kgy	KGY						
kha	KHA	KHA	kha	KHA	kha		
khb	KHB						
khc	KHC						
khd	KHD						
khe	KHE						
khf	KHF						
khg	KHG						
khh	KHH						
khj	KHJ						
khk	KHK						
khl	KHL						
khm	KHM	KHM	khm	KHM	khm	km	KM
khn	KHN						
kho	KHO	KHO	kho	KHO	kho		
khp	KHP						
khq	KHQ						
khr	KHR						
khs	KHS						
kht	KHT						
khu	KHU						
khv	KHV						
khw	KHW						
khx	KHX						
khy	KHY						
khz	KHZ						
kia	KIA						
kib	KIB						
kic	KIC						
kid	KID						
kie	KIE						
kif	KIF						
kig	KIG						
kih	KIH						
kii	KII						
kij	KIJ						
kik	KIK	KIK	kik	KIK	kik	ki	KI
kil	KIL						
kim	KIM						
kin	KIN	KIN	kin	KIN	kin	rw	RW
kio	KIO						
kip	KIP						
kiq	KIQ						
kir	KIR	KIR	kir	KIR	kir	ky	KY
kis	KIS						
kit	KIT						
kiu	KIU						
kiv	KIV						
kiw	KIW						
kix	KIX						
kiy	KIY						
kiz	KIZ						
kja	KJA						
kjb	KJB						
kjc	KJC						
kjd	KJD						
kje	KJE						
kjg	KJG						
kjh	KJH						
kji	KJI						
kjj	KJJ						
kjk	KJK						
kjl	KJL						
kjm	KJM						
kjn	KJN						
kjo	KJO						
kjp	KJP						
kjq	KJQ						
kjr	KJR						
kjs	KJS						
kjt	KJT						
kju	KJU						
kjv	KJV						
kjx	KJX						
kjy	KJY						
kjz	KJZ						
kka	KKA						
kkb	KKB						
kkc	KKC						
kkd	KKD						
kke	KKE						
kkf	KKF						
kkg	KKG						
kkh	KKH						
kki	KKI						
kkj	KKJ						
kkk	KKK						
kkl	KKL						
kkm	KKM						
kkn	KKN						
kko	KKO						
kkp	KKP						
kkq	KKQ						
kkr	KKR						
kks	KKS						
kkt	KKT						
kku	KKU						
kkv	KKV						
kkw	KKW						
kkx	KKX						
kky	KKY						
kkz	KKZ						
kla	KLA						
klb	KLB						
klc	KLC						
kld	KLD						
kle	KLE						
klf	KLF						
klg	KLG						
klh	KLH						
kli	KLI						
klj	KLJ						
klk	KLK						
kll	KLL						
klm	KLM						
kln	KLN						
klo	KLO						
klp	KLP						
klq	KLQ						
klr	KLR						
kls	KLS						
klt	KLT						
klu	KLU						
klv	KLV						
klw	KLW						
klx	KLX						
kly	KLY						
klz	KLZ						
kma	KMA						
kmb	KMB	KMB	kmb	KMB	kmb		
kmc	KMC						
kmd	KMD						
kme	KME						
kmf	KMF						
kmg	KMG						
kmh	KMH						
kmi	KMI						
kmj	KMJ						
kmk	KMK						
kml	KML						
kmm	KMM						
kmn	KMN						
kmo	KMO						
kmp	KMP						
kmq	KMQ						
kmr	KMR						
kms	KMS						
kmt	KMT						
kmu	KMU						
kmv	KMV						
kmw	KMW						
kmx	KMX						
kmy	KMY						
kmz	KMZ						
kna	KNA						
knb	KNB						
knc	KNC						
knd	KND						
kne	KNE						
knf	KNF						
kng	KNG						
kni	KNI						
knj	KNJ						
knk	KNK						
knl	KNL						
knm	KNM						
knn	KNN						
kno	KNO						
knp	KNP						
knq	KNQ						
knr	KNR						
kns	KNS						
knt	KNT						
knu	KNU						
knv	KNV						
knw	KNW						
knx	KNX						
kny	KNY						
knz	KNZ						
koa	KOA						
koc	KOC						
kod	KOD						
koe	KOE						
kof	KOF						
kog	KOG						
koh	KOH						
koi	KOI						
kok	KOK	KOK	kok	KOK	kok		
kol	KOL						
kom	KOM	KOM	kom	KOM	kom	kv	KV
kon	KON	KON	kon	KON	kon	kg	KG
koo	KOO						
kop	KOP						
koq	KOQ						
kor	KOR	KOR	kor	KOR	kor	ko	KO
kos	KOS	KOS	kos	KOS	kos		
kot	KOT						
kou	KOU						
kov	KOV						
kow	KOW						
koy	KOY						
koz	KOZ						
kpa	KPA						
kpb	KPB						
kpc	KPC						
kpd	KPD						
kpe	KPE	KPE	kpe	KPE	kpe		
kpf	KPF						
kpg	KPG						
kph	KPH						
kpi	KPI						
kpj	KPJ						
kpk	KPK						
kpl	KPL						
kpm	KPM						
kpn	KPN						
kpo	KPO						
kpq	KPQ						
kpr	KPR						
kps	KPS						
kpt	KPT						
kpu	KPU						
kpv	KPV						
kpw	KPW						
kpx	KPX						
kpy	KPY						
kpz	KPZ						
kqa	KQA						
kqb	KQB						
kqc	KQC						
kqd	KQD						
kqe	KQE						
kqf	KQF						
kqg	KQG						
kqh	KQH						
kqi	KQI						
kqj	KQJ						
kqk	KQK						
kql	KQL						
kqm	KQM						
kqn	KQN						
kqo	KQO						
kqp	KQP						
kqq	KQQ						
kqr	KQR						
kqs	KQS						
kqt	KQT						
kqu	KQU						
kqv	KQV						
kqw	KQW						
kqx	KQX						
kqy	KQY						
kqz	KQZ						
kra	KRA						
krb	KRB						
krc	KRC	KRC	krc	KRC	krc		
krd	KRD						
kre	KRE						
krf	KRF						
krh	KRH						
kri	KRI						
krj	KRJ						
krk	KRK						
krl	KRL	KRL	krl	KRL	krl		
krn	KRN						
krp	KRP						
krr	KRR						
krs	KRS						
krt	KRT						
kru	KRU	KRU	kru	KRU	kru		
krv	KRV						
krw	KRW						
krx	KRX						
kry	KRY						
krz	KRZ						
ksa	KSA						
ksb	KSB						
ksc	KSC						
ksd	KSD						
kse	KSE						
ksf	KSF						
ksg	KSG						
ksh	KSH						
ksi	KSI						
ksj	KSJ						
ksk	KSK						
ksl	KSL						
ksm	KSM						
ksn	KSN						
kso	KSO						
ksp	KSP						
ksq	KSQ						
ksr	KSR						
kss	KSS						
kst	KST						
ksu	KSU						
ksv	KSV						
ksw	KSW						
ksx	KSX						
ksy	KSY						
ksz	KSZ						
kta	KTA						
ktb	KTB						
ktc	KTC						
ktd	KTD						
kte	KTE						
ktf	KTF						
ktg	KTG						
kth	KTH						
kti	KTI						
ktj	KTJ						
ktk	KTK						
ktl	KTL						
ktm	KTM						
ktn	KTN						
kto	KTO						
ktp	KTP						
ktq	KTQ						
kts	KTS						
ktt	KTT						
ktu	KTU						
ktv	KTV						
ktw	KTW						
ktx	KTX						
kty	KTY						
ktz	KTZ						
kua	KUA	KUA	kua	KUA	kua	kj	KJ
kub	KUB						
kuc	KUC						
kud	KUD						
kue	KUE						
kuf	KUF						
kug	KUG						
kuh	KUH						
kui	KUI						
kuj	KUJ						
kuk	KUK						
kul	KUL						
kum	KUM	KUM	kum	KUM	kum		
kun	KUN						
kuo	KUO						
kup	KUP						
kuq	KUQ						
kur	KUR	KUR	kur	KUR	kur	ku	KU
kus	KUS						
kut	KUT	KUT	kut	KUT	kut		
kuu	KUU						
kuv	KUV						
kuw	KUW						
kux	KUX						
kuy	KUY						
kuz	KUZ						
kva	KVA						
kvb	KVB						
kvc	KVC						
kvd	KVD						
kve	KVE						
kvf	KVF						
kvg	KVG						
kvh	KVH						
kvi	KVI						
kvj	KVJ						
kvk	KVK						
kvl	KVL						
kvm	KVM						
kvn	KVN						
kvo	KVO						
kvp	KVP						
kvq	KVQ						
kvr	KVR						
kvt	KVT						
kvu	KVU						
kvv	KVV						
kvw	KVW						
kvx	KVX						
kvy	KVY						
kvz	KVZ						
kwa	KWA						
kwb	KWB						
kwc	KWC						
kwd	KWD						
kwe	KWE						
kwf	KWF						
kwg	KWG						
kwh	KWH						
kwi	KWI						
kwj	KWJ						
kwk	KWK						
kwl	KWL						
kwm	KWM						
kwn	KWN						
kwo	KWO						
kwp	KWP						
kwr	KWR						
kws	KWS						
kwt	KWT						
kwu	KWU						
kwv	KWV						
kww	KWW						
kwx	KWX						
kwy	KWY						
kwz	KWZ						
kxa	KXA						
kxb	KXB						
kxc	KXC						
kxd	KXD						
kxf	KXF						
kxh	KXH						
kxi	KXI						
kxj	KXJ						
kxk	KXK						
kxm	KXM						
kxn	KXN						
kxo	KXO						
kxp	KXP						
kxq	KXQ						
kxr	KXR						
kxs	KXS						
kxt	KXT						
kxv	KXV						
kxw	KXW						
kxx	KXX						
kxy	KXY						
kxz	KXZ						
kya	KYA						
kyb	KYB						
kyc	KYC						
kyd	KYD						
kye	KYE						
kyf	KYF						
kyg	KYG						
kyh	KYH						
kyi	KYI						
kyj	KYJ						
kyk	KYK						
kyl	KYL						
kym	KYM						
kyn	KYN						
kyo	KYO						
kyp	KYP						
kyq	KYQ						
kyr	KYR						
kys	KYS						
kyt	KYT						
kyu	KYU						
kyv	KYV						
kyw	KYW						
kyx	KYX						
kyy	KYY						
kyz	KYZ						
kza	KZA						
kzb	KZB						
kzc	KZC						
kzd	KZD						
kze	KZE						
kzf	KZF						
kzg	KZG						
kzi	KZI						
kzk	KZK						
kzl	KZL						
kzm	KZM						
kzn	KZN						
kzo	KZO						
kzp	KZP						
kzq	KZQ						
kzr	KZR						
kzs	KZS						
kzu	KZU						
kzv	KZV						
kzw	KZW						
kzx	KZX						
kzy	KZY						
kzz	KZZ						
laa	LAA						
lab	LAB						
lac	LAC						
lad	LAD	LAD	lad	LAD	lad		
lae	LAE						
laf	LAF						
lag	LAG						
lah	LAH	LAH	lah	LAH	lah		
lai	LAI						
laj	LAJ						
lak	LAK						
lal	LAL						
lam	LAM	LAM	lam	LAM	lam		
lan	LAN						
lao	LAO	LAO	lao	LAO	lao	lo	LO
lap	LAP						
laq	LAQ						
lar	LAR						
las	LAS						
lat	LAT	LAT	lat	LAT	lat	la	LA
lau	LAU						
lav	LAV	LAV	lav	LAV	lav	lv	LV
law	LAW						
lax	LAX						
lay	LAY						
laz	LAZ						
lbb	LBB						
lbc	LBC						
lbe	LBE						
lbf	LBF						
lbg	LBG						
lbi	LBI						
lbj	LBJ						
lbk	LBK						
lbl	LBL						
lbm	LBM						
lbn	LBN						
lbo	LBO						
lbq	LBQ						
lbr	LBR						
lbs	LBS						
lbt	LBT						
lbu	LBU						
lbv	LBV						
lbw	LBW						
lbx	LBX						
lby	LBY						
lbz	LBZ						
lcc	LCC						
lcd	LCD						
lce	LCE						
lcf	LCF						
lch	LCH						
lcl	LCL						
lcm	LCM						
lcp	LCP						
lcq	LCQ						
lcs	LCS						
lda	LDA						
ldb	LDB						
ldd	LDD						
ldg	LDG						
ldh	LDH						
ldi	LDI						
ldj	LDJ						
ldk	LDK						
ldl	LDL						
ldm	LDM						
ldn	LDN						
ldo	LDO						
ldp	LDP						
ldq	LDQ						
lea	LEA						
leb	LEB						
lec	LEC						
led	LED						
lee	LEE						
lef	LEF						
leh	LEH						
lei	LEI						
lej	LEJ						
lek	LEK						
lel	LEL						
lem	LEM						
len	LEN						
leo	LEO						
lep	LEP						
leq	LEQ						
ler	LER						
les	LES						
let	LET						
leu	LEU						
lev	LEV						
lew	LEW						
lex	LEX						
ley	LEY						
lez	LEZ	LEZ	lez	LEZ	lez		
lfa	LFA						
lfn	LFN						
lga	LGA						
lgb	LGB						
lgg	LGG						
lgh	LGH						
lgi	LGI						
lgk	LGK						
lgl	LGL						
lgm	LGM						
lgn	LGN						
lgq	LGQ						
lgr	LGR						
lgt	LGT						
lgu	LGU						
lgz	LGZ						
lha	LHA						
lhh	LHH						
lhi	LHI						
lhl	LHL						
lhm	LHM						
lhn	LHN						
lhp	LHP						
lhs	LHS						
lht	LHT						
lhu	LHU						
lia	LIA						
lib	LIB						
lic	LIC						
lid	LID						
lie	LIE						
lif	LIF						
lig	LIG						
lih	LIH						
lij	LIJ						
lik	LIK						
lil	LIL						
lim	LIM	LIM	lim	LIM	lim	li	LI
lin	LIN	LIN	lin	LIN	lin	ln	LN
lio	LIO						
lip	LIP						
liq	LIQ						
lir	LIR						
lis	LIS						
lit	LIT	LIT	lit	LIT	lit	lt	LT
liu	LIU						
liv	LIV						
liw	LIW						
lix	LIX						
liy	LIY						
liz	LIZ						
lja	LJA						
lje	LJE						
lji	LJI						
ljl	LJL						
ljp	LJP						
ljw	LJW						
ljx	LJX						
lka	LKA						
lkb	LKB						
lkc	LKC						
lkd	LKD						
lke	LKE						
lkh	LKH						
lki	LKI						
lkj	LKJ						
lkl	LKL						
lkm	LKM						
lkn	LKN						
lko	LKO						
lkr	LKR						
lks	LKS						
lkt	LKT						
lku	LKU						
lky	LKY						
lla	LLA						
llb	LLB						
llc	LLC						
lld	LLD						
lle	LLE						
llf	LLF						
llg	LLG						
llh	LLH						
lli	LLI						
llj	LLJ						
llk	LLK						
lll	LLL						
llm	LLM						
lln	LLN						
llp	LLP						
llq	LLQ						
lls	LLS						
llu	LLU						
llx	LLX						
lma	LMA						
lmb	LMB						
lmc	LMC						
lmd	LMD						
lme	LME						
lmf	LMF						
lmg	LMG						
lmh	LMH						
lmi	LMI						
lmj	LMJ						
lmk	LMK						
lml	LML						
lmn	LMN						
lmo	LMO						
lmp	LMP						
lmq	LMQ						
lmr	LMR						
lmu	LMU						
lmv	LMV						
lmw	LMW						
lmx	LMX						
lmy	LMY						
lna	LNA						
lnb	LNB						
lnd	LND						
lng	LNG						
lnh	LNH						
lni	LNI						
lnj	LNJ						
lnl	LNL						
lnm	LNM						
lnn	LNN						
lno	LNO						
lns	LNS						
lnu	LNU						
lnw	LNW						
lnz	LNZ						
loa	LOA						
lob	LOB						
loc	LOC						
loe	LOE						
lof	LOF						
log	LOG						
loh	LOH						
loi	LOI						
loj	LOJ						
lok	LOK						
lol	LOL	LOL	lol	LOL	lol		
lom	LOM						
lon	LON						
loo	LOO						
lop	LOP						
loq	LOQ						
lor	LOR						
los	LOS						
lot	LOT						
lou	LOU						
lov	LOV						
low	LOW						
lox	LOX						
loy	LOY						
loz	LOZ	LOZ	loz	LOZ	loz		
lpa	LPA						
lpe	LPE						
lpn	LPN						
lpo	LPO						
lpx	LPX						
lra	LRA						
lrc	LRC						
lre	LRE						
lrg	LRG						
lri	LRI						
lrk	LRK						
lrl	LRL						
lrm	LRM						
lrn	LRN						
lro	LRO						
lrr	LRR						
lrt	LRT						
lrv	LRV						
lrz	LRZ						
lsa	LSA						
lsd	LSD						
lse	LSE						
lsh	LSH						
lsi	LSI						
lsl	LSL						
lsm	LSM						
lsn	LSN						
lso	LSO						
lsp	LSP						
lsr	LSR						
lss	LSS						
lst	LST						
lsv	LSV						
lsy	LSY						
ltc	LTC						
ltg	LTG						
lth	LTH						
lti	LTI						
ltn	LTN						
lto	LTO						
lts	LTS						
ltu	LTU						
ltz	LTZ	LTZ	ltz	LTZ	ltz	lb	LB
lua	LUA	LUA	lua	LUA	lua		
lub	LUB	LUB	lub	LUB	lub	lu	LU
luc	LUC						
lud	LUD						
lue	LUE						
luf	LUF						
lug	LUG	LUG	lug	LUG	lug	lg	LG
lui	LUI	LUI	lui	LUI	lui		
luj	LUJ						
luk	LUK						
lul	LUL						
lum	LUM						
lun	LUN	LUN	lun	LUN	lun		
luo	LUO	LUO	luo	LUO	luo		
lup	LUP						
luq	LUQ						
lur	LUR						
lus	LUS	LUS	lus	LUS	lus		
lut	LUT						
luu	LUU						
luv	LUV						
luw	LUW						
luy	LUY						
luz	LUZ						
lva	LVA						
lvi	LVI						
lvk	LVK						
lvs	LVS						
lvu	LVU						
lwa	LWA						
lwe	LWE						
lwg	LWG						
lwh	LWH						
lwl	LWL						
lwm	LWM						
lwo	LWO						
lws	LWS						
lwt	LWT						
lwu	LWU						
lww	LWW						
lya	LYA						
lyg	LYG						
lyn	LYN						
lzh	LZH						
lzl	LZL						
lzn	LZN						
lzz	LZZ						
maa	MAA						
mab	MAB						
mad	MAD	MAD	mad	MAD	mad		
mae	MAE						
maf	MAF						
mag	MAG	MAG	mag	MAG	mag		
mah	MAH	MAH	mah	MAH	mah	mh	MH
mai	MAI	MAI	mai	MAI	mai		
maj	MAJ						
mak	MAK	MAK	mak	MAK	mak		
mal	MAL	MAL	mal	MAL	mal	ml	ML
mam	MAM						
man	MAN	MAN	man	MAN	man		
maq	MAQ						
mar	MAR	MAR	mar	MAR	mar	mr	MR
mas	MAS	MAS	mas	MAS	mas		
mat	MAT						
mau	MAU						
mav	MAV						
maw	MAW						
max	MAX						
maz	MAZ						
mba	MBA						
mbb	MBB						
mbc	MBC						
mbd	MBD						
mbe	MBE						
mbf	MBF						
mbh	MBH						
mbi	MBI						
mbj	MBJ						
mbk	MBK						
mbl	MBL						
mbm	MBM						
mbn	MBN						
mbo	MBO						
mbp	MBP						
mbq	MBQ						
mbr	MBR						
mbs	MBS						
mbt	MBT						
mbu	MBU						
mbv	MBV						
mbw	MBW						
mbx	MBX						
mby	MBY						
mbz	MBZ						
mca	MCA						
mcb	MCB						
mcc	MCC						
mcd	MCD						
mce	MCE						
mcf	MCF						
mcg	MCG						
mch	MCH						
mci	MCI						
mcj	MCJ						
mck	MCK						
mcl	MCL						
mcm	MCM						
mcn	MCN						
mco	MCO						
mcp	MCP						
mcq	MCQ						
mcr	MCR						
mcs	MCS						
mct	MCT						
mcu	MCU						
mcv	MCV						
mcw	MCW						
mcx	MCX						
mcy	MCY						
mcz	MCZ						
mda	MDA						
mdb	MDB						
mdc	MDC						
mdd	MDD						
mde	MDE						
mdf	MDF	MDF	mdf	MDF	mdf		
mdg	MDG						
mdh	MDH						
mdi	MDI						
mdj	MDJ						
mdk	MDK						
mdl	MDL						
mdm	MDM						
mdn	MDN						
mdp	MDP						
mdq	MDQ						
mdr	MDR	MDR	mdr	MDR	mdr		
mds	MDS						
mdt	MDT						
mdu	MDU						
mdv	MDV						
mdw	MDW						
mdx	MDX						
mdy	MDY						
mdz	MDZ						
mea	MEA						
meb	MEB						
mec	MEC						
med	MED						
mee	MEE						
mef	MEF						
meh	MEH						
mei	MEI						
mej	MEJ						
mek	MEK						
mel	MEL						
mem	MEM						
men	MEN	MEN	men	MEN	men		
meo	MEO						
mep	MEP						
meq	MEQ						
mer	MER						
mes	MES						
met	MET						
meu	MEU						
mev	MEV						
mew	MEW						
mey	MEY						
mez	MEZ						
mfa	MFA						
mfb	MFB						
mfc	MFC						
mfd	MFD						
mfe	MFE						
mff	MFF						
mfg	MFG						
mfh	MFH						
mfi	MFI						
mfj	MFJ						
mfk	MFK						
mfl	MFL						
mfm	MFM						
mfn	MFN						
mfo	MFO						
mfp	MFP						
mfq	MFQ						
mfr	MFR						
mfs	MFS						
mft	MFT						
mfu	MFU						
mfv	MFV						
mfw	MFW						
mfx	MFX						
mfy	MFY						
mfz	MFZ						
mga	MGA	MGA	mga	MGA	mga		
mgb	MGB						
mgc	MGC						
mgd	MGD						
mge	MGE						
mgf	MGF						
mgg	MGG						
mgh	MGH						
mgi	MGI						
mgj	MGJ						
mgk	MGK						
mgl	MGL						
mgm	MGM						
mgn	MGN						
mgo	MGO						
mgp	MGP						
mgq	MGQ						
mgr	MGR						
mgs	MGS						
mgt	MGT						
mgu	MGU						
mgv	MGV						
mgw	MGW						
mgy	MGY						
mgz	MGZ						
mha	MHA						
mhb	MHB						
mhc	MHC						
mhd	MHD						
mhe	MHE						
mhf	MHF						
mhg	MHG						
mhi	MHI						
mhj	MHJ						
mhk	MHK						
mhl	MHL						
mhm	MHM						
mhn	MHN						
mho	MHO						
mhp	MHP						
mhq	MHQ						
mhr	MHR						
mhs	MHS						
mht	MHT						
mhu	MHU						
mhw	MHW						
mhx	MHX						
mhy	MHY						
mhz	MHZ						
mia	MIA						
mib	MIB						
mic	MIC	MIC	mic	MIC	mic		
mid	MID						
mie	MIE						
mif	MIF						
mig	MIG						
mih	MIH						
mii	MII						
mij	MIJ						
mik	MIK						
mil	MIL						
mim	MIM						
min	MIN	MIN	min	MIN	min		
mio	MIO						
mip	MIP						
miq	MIQ						
mir	MIR						
mis	MIS	MIS	mis	MIS	mis		
mit	MIT						
miu	MIU						
miw	MIW						
mix	MIX						
miy	MIY						
miz	MIZ						
mjb	MJB						
mjc	MJC						
mjd	MJD						
mje	MJE						
mjg	MJG						
mjh	MJH						
mji	MJI						
mjj	MJJ						
mjk	MJK						
mjl	MJL						
mjm	MJM						
mjn	MJN						
mjo	MJO						
mjp	MJP						
mjq	MJQ						
mjr	MJR						
mjs	MJS						
mjt	MJT						
mju	MJU						
mjv	MJV						
mjw	MJW						
mjx	MJX						
mjy	MJY						
mjz	MJZ						
mka	MKA						
mkb	MKB						
mkc	MKC						
mkd	MKD	MAC	mac	MKD	mkd	mk	MK
mke	MKE						
mkf	MKF						
mkg	MKG						
mki	MKI						
mkj	MKJ						
mkk	MKK						
mkl	MKL						
mkm	MKM						
mkn	MKN						
mko	MKO						
mkp	MKP						
mkq	MKQ						
mkr	MKR						
mks	MKS						
mkt	MKT						
mku	MKU						
mkv	MKV						
mkw	MKW						
mkx	MKX						
mky	MKY						
mkz	MKZ						
mla	MLA						
mlb	MLB						
mlc	MLC						
mle	MLE						
mlf	MLF						
mlg	MLG	MLG	mlg	MLG	mlg	mg	MG
mlh	MLH						
mli	MLI						
mlj	MLJ						
mlk	MLK						
mll	MLL						
mlm	MLM						
mln	MLN						
mlo	MLO						
mlp	MLP						
mlq	MLQ						
mlr	MLR						
mls	MLS						
mlt	MLT	MLT	mlt	MLT	mlt	mt	MT
mlu	MLU						
mlv	MLV						
mlw	MLW						
mlx	MLX						
mlz	MLZ						
mma	MMA						
mmb	MMB						
mmc	MMC						
mmd	MMD						
mme	MME						
mmf	MMF						
mmg	MMG						
mmh	MMH						
mmi	MMI						
mmj	MMJ						
mmk	MMK						
mml	MML						
mmm	MMM						
mmn	MMN						
mmo	MMO						
mmp	MMP						
mmq	MMQ						
mmr	MMR						
mmt	MMT						
mmu	MMU						
mmv	MMV						
mmw	MMW						
mmx	MMX						
mmy	MMY						
mmz	MMZ						
mna	MNA						
mnb	MNB						
mnc	MNC	MNC	mnc	MNC	mnc		
mnd	MND						
mne	MNE						
mnf	MNF						
mng	MNG						
mnh	MNH						
mni	MNI	MNI	mni	MNI	mni		
mnj	MNJ						
mnk	MNK						
mnl	MNL						
mnm	MNM						
mnn	MNN						
mnp	MNP						
mnq	MNQ						
mnr	MNR						
mns	MNS						
mnu	MNU						
mnv	MNV						
mnw	MNW						
mnx	MNX						
mny	MNY						
mnz	MNZ						
moa	MOA						
moc	MOC						
mod	MOD						
moe	MOE						
mog	MOG						
moh	MOH	MOH	moh	MOH	moh		
moi	MOI						
moj	MOJ						
mok	MOK						
mom	MOM						
mon	MON	MON	mon	MON	mon	mn	MN
moo	MOO						
mop	MOP						
moq	MOQ						
mor	MOR						
mos	MOS	MOS	mos	MOS	mos		
mot	MOT						
mou	MOU						
mov	MOV						
mow	MOW						
mox	MOX						
moy	MOY						
moz	MOZ						
mpa	MPA						
mpb	MPB						
mpc	MPC						
mpd	MPD						
mpe	MPE						
mpg	MPG						
mph	MPH						
mpi	MPI						
mpj	MPJ						
mpk	MPK						
mpl	MPL						
mpm	MPM						
mpn	MPN						
mpo	MPO						
mpp	MPP						
mpq	MPQ						
mpr	MPR						
mps	MPS						
mpt	MPT						
mpu	MPU						
mpv	MPV						
mpw	MPW						
mpx	MPX						
mpy	MPY						
mpz	MPZ						
mqa	MQA						
mqb	MQB						
mqc	MQC						
mqe	MQE						
mqf	MQF						
mqg	MQG						
mqh	MQH						
mqi	MQI						
mqj	MQJ						
mqk	MQK						
mql	MQL						
mqm	MQM						
mqn	MQN						
mqo	MQO						
mqp	MQP						
mqq	MQQ						
mqr	MQR						
mqs	MQS						
mqt	MQT						
mqu	MQU						
mqv	MQV						
mqw	MQW						
mqx	MQX						
mqy	MQY						
mqz	MQZ						
mra	MRA						
mrb	MRB						
mrc	MRC						
mrd	MRD						
mre	MRE						
mrf	MRF						
mrg	MRG						
mrh	MRH						
mri	MRI	MAO	mao	MRI	mri	mi	MI
mrj	MRJ						
mrk	MRK						
mrl	MRL						
mrm	MRM						
mrn	MRN						
mro	MRO						
mrp	MRP						
mrq	MRQ						
mrr	MRR						
mrs	MRS						
mrt	MRT						
mru	MRU						
mrv	MRV						
mrw	MRW						
mrx	MRX						
mry	MRY						
mrz	MRZ						
msa	MSA	MAY	may	MSA	msa	ms	MS
msb	MSB						
msc	MSC						
msd	MSD						
mse	MSE						
msf	MSF						
msg	MSG						
msh	MSH						
msi	MSI						
msj	MSJ						
msk	MSK						
msl	MSL						
msm	MSM						
msn	MSN						
mso	MSO						
msp	MSP						
msq	MSQ						
msr	MSR						
mss	MSS						
msu	MSU						
msv	MSV						
msw	MSW						
msx	MSX						
msy	MSY						
msz	MSZ						
mta	MTA						
mtb	MTB						
mtc	MTC						
mtd	MTD						
mte	MTE						
mtf	MTF						
mtg	MTG						
mth	MTH						
mti	MTI						
mtj	MTJ						
mtk	MTK						
mtl	MTL						
mtm	MTM						
mtn	MTN						
mto	MTO						
mtp	MTP						
mtq	MTQ						
mtr	MTR						
mts	MTS						
mtt	MTT						
mtu	MTU						
mtv	MTV						
mtw	MTW						
mtx	MTX						
mty	MTY						
mua	MUA						
mub	MUB						
muc	MUC						
mud	MUD						
mue	MUE						
mug	MUG						
muh	MUH						
mui	MUI						
muj	MUJ						
muk	MUK						
mul	MUL	MUL	mul	MUL	mul		
mum	MUM						
muo	MUO						
mup	MUP						
muq	MUQ						
mur	MUR						
mus	MUS	MUS	mus	MUS	mus		
mut	MUT						
muu	MUU						
muv	MUV						
mux	MUX						
muy	MUY						
muz	MUZ						
mva	MVA						
mvb	MVB						
mvd	MVD						
mve	MVE						
mvf	MVF						
mvg	MVG						
mvh	MVH						
mvi	MVI						
mvk	MVK						
mvl	MVL						
mvm	MVM						
mvn	MVN						
mvo	MVO						
mvp	MVP						
mvq	MVQ						
mvr	MVR						
mvs	MVS						
mvt	MVT						
mvu	MVU						
mvv	MVV						
mvw	MVW						
mvx	MVX						
mvy	MVY						
mvz	MVZ						
mwa	MWA						
mwb	MWB						
mwc	MWC						
mwe	MWE						
mwf	MWF						
mwg	MWG						
mwh	MWH						
mwi	MWI						
mwk	MWK						
mwl	MWL	MWL	mwl	MWL	mwl		
mwm	MWM						
mwn	MWN						
mwo	MWO						
mwp	MWP						
mwq	MWQ						
mwr	MWR	MWR	mwr	MWR	mwr		
mws	MWS						
mwt	MWT						
mwu	MWU						
mwv	MWV						
mww	MWW						
mwz	MWZ						
mxa	MXA						
mxb	MXB						
mxc	MXC						
mxd	MXD						
mxe	MXE						
mxf	MXF						
mxg	MXG						
mxh	MXH						
mxi	MXI						
mxj	MXJ						
mxk	MXK						
mxl	MXL						
mxm	MXM						
mxn	MXN						
mxo	MXO						
mxp	MXP						
mxq	MXQ						
mxr	MXR						
mxs	MXS						
mxt	MXT						
mxu	MXU						
mxv	MXV						
mxw	MXW						
mxx	MXX						
mxy	MXY						
mxz	MXZ						
mya	MYA	BUR	bur	MYA	mya	my	MY
myb	MYB						
myc	MYC						
mye	MYE						
myf	MYF						
myg	MYG						
myh	MYH						
myj	MYJ						
myk	MYK						
myl	MYL						
mym	MYM						
myo	MYO						
myp	MYP						
myr	MYR						
mys	MYS						
myu	MYU						
myv	MYV	MYV	myv	MYV	myv		
myw	MYW						
myx	MYX						
myy	MYY						
myz	MYZ						
mza	MZA						
mzb	MZB						
mzc	MZC						
mzd	MZD						
mze	MZE						
mzg	MZG						
mzh	MZH						
mzi	MZI						
mzj	MZJ						
mzk	MZK						
mzl	MZL						
mzm	MZM						
mzn	MZN						
mzo	MZO						
mzp	MZP						
mzq	MZQ						
mzr	MZR						
mzs	MZS						
mzt	MZT						
mzu	MZU						
mzv	MZV						
mzw	MZW						
mzx	MZX						
mzy	MZY						
mzz	MZZ						
naa	NAA						
nab	NAB						
nac	NAC						
nae	NAE						
naf	NAF						
nag	NAG						
naj	NAJ						
nak	NAK						
nal	NAL						
nam	NAM						
nan	NAN						
nao	NAO						
nap	NAP	NAP	nap	NAP	nap		
naq	NAQ						
nar	NAR						
nas	NAS						
nat	NAT						
nau	NAU	NAU	nau	NAU	nau	na	NA
nav	NAV	NAV	nav	NAV	nav	nv	NV
naw	NAW						
nax	NAX						
nay	NAY						
naz	NAZ						
nba	NBA						
nbb	NBB						
nbc	NBC						
nbd	NBD						
nbe	NBE						
nbg	NBG						
nbh	NBH						
nbi	NBI						
nbj	NBJ						
nbk	NBK						
nbl	NBL	NBL	nbl	NBL	nbl	nr	NR
nbm	NBM						
nbn	NBN						
nbo	NBO						
nbp	NBP						
nbq	NBQ						
nbr	NBR						
nbs	NBS						
nbt	NBT						
nbu	NBU						
nbv	NBV						
nbw	NBW						
nby	NBY						
nca	NCA						
ncb	NCB						
ncc	NCC						
ncd	NCD						
nce	NCE						
ncf	NCF						
ncg	NCG						
nch	NCH						
nci	NCI						
ncj	NCJ						
nck	NCK						
ncl	NCL						
ncm	NCM						
ncn	NCN						
nco	NCO						
ncq	NCQ						
ncr	NCR						
ncs	NCS						
nct	NCT						
ncu	NCU						
ncx	NCX						
ncz	NCZ						
nda	NDA						
ndb	NDB						
ndc	NDC						
ndd	NDD						
nde	NDE	NDE	nde	NDE	nde	nd	ND
ndf	NDF						
ndg	NDG						
ndh	NDH						
ndi	NDI						
ndj	NDJ						
ndk	NDK						
ndl	NDL						
ndm	NDM						
ndn	NDN						
ndo	NDO	NDO	ndo	NDO	ndo	ng	NG
ndp	NDP						
ndq	NDQ						
ndr	NDR						
nds	NDS	NDS	nds	NDS	nds		
ndt	NDT						
ndu	NDU						
ndv	NDV						
ndw	NDW						
ndx	NDX						
ndy	NDY						
ndz	NDZ						
nea	NEA						
neb	NEB						
nec	NEC						
ned	NED						
nee	NEE						
nef	NEF						
neg	NEG						
neh	NEH						
nei	NEI						
nej	NEJ						
nek	NEK						
nem	NEM						
nen	NEN						
neo	NEO						
nep	NEP	NEP	nep	NEP	nep	ne	NE
neq	NEQ						
ner	NER						
nes	NES						
net	NET						
neu	NEU						
nev	NEV						
new	NEW	NEW	new	NEW	new		
nex	NEX						
ney	NEY						
nez	NEZ						
nfa	NFA						
nfd	NFD						
nfl	NFL						
nfr	NFR						
nfu	NFU						
nga	NGA						
ngb	NGB						
ngc	NGC						
ngd	NGD						
nge	NGE						
ngg	NGG						
ngh	NGH						
ngi	NGI						
ngj	NGJ						
ngk	NGK						
ngl	NGL						
ngm	NGM						
ngn	NGN						
ngo	NGO						
ngp	NGP						
ngq	NGQ						
ngr	NGR						
ngs	NGS						
ngt	NGT						
ngu	NGU						
ngv	NGV						
ngw	NGW						
ngx	NGX						
ngy	NGY						
ngz	NGZ						
nha	NHA						
nhb	NHB						
nhc	NHC						
nhd	NHD						
nhe	NHE						
nhf	NHF						
nhg	NHG						
nhh	NHH						
nhi	NHI						
nhk	NHK						
nhm	NHM						
nhn	NHN						
nho	NHO						
nhp	NHP						
nhq	NHQ						
nhr	NHR						
nht	NHT						
nhu	NHU						
nhv	NHV						
nhw	NHW						
nhx	NHX						
nhy	NHY						
nhz	NHZ						
nia	NIA	NIA	nia	NIA	nia		
nib	NIB						
nid	NID						
nie	NIE						
nif	NIF						
nig	NIG						
nih	NIH						
nii	NII						
nij	NIJ						
nik	NIK						
nil	NIL						
nim	NIM						
nin	NIN						
nio	NIO						
niq	NIQ						
nir	NIR						
nis	NIS						
nit	NIT						
niu	NIU	NIU	niu	NIU	niu		
niv	NIV						
niw	NIW						
nix	NIX						
niy	NIY						
niz	NIZ						
nja	NJA						
njb	NJB						
njd	NJD						
njh	NJH						
nji	NJI						
njj	NJJ						
njl	NJL						
njm	NJM						
njn	NJN						
njo	NJO						
njr	NJR						
njs	NJS						
njt	NJT						
nju	NJU						
njx	NJX						
njy	NJY						
njz	NJZ						
nka	NKA						
nkb	NKB						
nkc	NKC						
nkd	NKD						
nke	NKE						
nkf	NKF						
nkg	NKG						
nkh	NKH						
nki	NKI						
nkj	NKJ						
nkk	NKK						
nkm	NKM						
nkn	NKN						
nko	NKO						
nkp	NKP						
nkq	NKQ						
nkr	NKR						
nks	NKS						
nkt	NKT						
nku	NKU						
nkv	NKV						
nkw	NKW						
nkx	NKX						
nkz	NKZ						
nla	NLA						
nlc	NLC						
nld	NLD	DUT	dut	NLD	nld	nl	NL
nle	NLE						
nlg	NLG						
nli	NLI						
nlj	NLJ						
nlk	NLK						
nll	NLL						
nlm	NLM						
nlo	NLO						
nlq	NLQ						
nlu	NLU						
nlv	NLV						
nlw	NLW						
nlx	NLX						
nly	NLY						
nlz	NLZ						
nma	NMA						
nmb	NMB						
nmc	NMC						
nmd	NMD						
nme	NME						
nmf	NMF						
nmg	NMG						
nmh	NMH						
nmi	NMI						
nmj	NMJ						
nmk	NMK						
nml	NML						
nmm	NMM						
nmn	NMN						
nmo	NMO						
nmp	NMP						
nmq	NMQ						
nmr	NMR						
nms	NMS						
nmt	NMT						
nmu	NMU						
nmv	NMV						
nmw	NMW						
nmx	NMX						
nmy	NMY						
nmz	NMZ						
nna	NNA						
nnb	NNB						
nnc	NNC						
nnd	NND						
nne	NNE						
nnf	NNF						
nng	NNG						
nnh	NNH						
nni	NNI						
nnj	NNJ						
nnk	NNK						
nnl	NNL						
nnm	NNM						
nnn	NNN						
nno	NNO	NNO	nno	NNO	nno	nn	NN
nnp	NNP						
nnq	NNQ						
nnr	NNR						
nnt	NNT						
nnu	NNU						
nnv	NNV						
nnw	NNW						
nny	NNY						
nnz	NNZ						
noa	NOA						
nob	NOB	NOB	nob	NOB	nob	nb	NB
noc	NOC						
nod	NOD						
noe	NOE						
nof	NOF						
nog	NOG	NOG	nog	NOG	nog		
noh	NOH						
noi	NOI						
noj	NOJ						
nok	NOK						
nol	NOL						
nom	NOM						
non	NON	NON	non	NON	non		
nop	NOP						
noq	NOQ						
nor	NOR	NOR	nor	NOR	nor	no	NO
nos	NOS						
not	NOT						
nou	NOU						
nov	NOV						
now	NOW						
noy	NOY						
noz	NOZ						
npa	NPA						
npb	NPB						
npg	NPG						
nph	NPH						
npi	NPI						
npl	NPL						
npn	NPN						
npo	NPO						
nps	NPS						
npu	NPU						
npx	NPX						
npy	NPY						
nqg	NQG						
nqk	NQK						
nql	NQL						
nqm	NQM						
nqn	NQN						
nqo	NQO	NQO	nqo	NQO	nqo		
nqq	NQQ						
nqy	NQY						
nra	NRA						
nrb	NRB						
nrc	NRC						
nre	NRE						
nrf	NRF						
nrg	NRG						
nri	NRI						
nrk	NRK						
nrl	NRL						
nrm	NRM						
nrn	NRN						
nrp	NRP						
nrr	NRR						
nrt	NRT						
nru	NRU						
nrx	NRX						
nrz	NRZ						
nsa	NSA						
nsb	NSB						
nsc	NSC						
nsd	NSD						
nse	NSE						
nsf	NSF						
nsg	NSG						
nsh	NSH						
nsi	NSI						
nsk	NSK						
nsl	NSL						
nsm	NSM						
nsn	NSN						
nso	NSO	NSO	nso	NSO	nso		
nsp	NSP						
nsq	NSQ						
nsr	NSR						
nss	NSS						
nst	NST						
nsu	NSU						
nsv	NSV						
nsw	NSW						
nsx	NSX						
nsy	NSY						
nsz	NSZ						
ntd	NTD						
nte	NTE						
ntg	NTG						
nti	NTI						
ntj	NTJ						
ntk	NTK						
ntm	NTM						
nto	NTO						
ntp	NTP						
ntr	NTR						
ntu	NTU						
ntw	NTW						
ntx	NTX						
nty	NTY						
ntz	NTZ						
nua	NUA						
nuc	NUC						
nud	NUD						
nue	NUE						
nuf	NUF						
nug	NUG						
nuh	NUH						
nui	NUI						
nuj	NUJ						
nuk	NUK						
nul	NUL						
num	NUM						
nun	NUN						
nuo	NUO						
nup	NUP						
nuq	NUQ						
nur	NUR						
nus	NUS						
nut	NUT						
nuu	NUU						
nuv	NUV						
nuw	NUW						
nux	NUX						
nuy	NUY						
nuz	NUZ						
nvh	NVH						
nvm	NVM						
nvo	NVO						
nwa	NWA						
nwb	NWB						
nwc	NWC	NWC	nwc	NWC	nwc		
nwe	NWE						
nwg	NWG						
nwi	NWI						
nwm	NWM						
nwo	NWO						
nwr	NWR						
nwx	NWX						
nwy	NWY						
nxa	NXA						
nxd	NXD						
nxe	NXE						
nxg	NXG						
nxi	NXI						
nxk	NXK						
nxl	NXL						
nxm	NXM						
nxn	NXN						
nxo	NXO						
nxq	NXQ						
nxr	NXR						
nxx	NXX						
nya	NYA	NYA	nya	NYA	nya	ny	NY
nyb	NYB						
nyc	NYC						
nyd	NYD						
nye	NYE						
nyf	NYF						
nyg	NYG						
nyh	NYH						
nyi	NYI						
nyj	NYJ						
nyk	NYK						
nyl	NYL						
nym	NYM	NYM	nym	NYM	nym		
nyn	NYN	NYN	nyn	NYN	nyn		
nyo	NYO	NYO	nyo	NYO	nyo		
nyp	NYP						
nyq	NYQ						
nyr	NYR						
nys	NYS						
nyt	NYT						
nyu	NYU						
nyv	NYV						
nyw	NYW						
nyx	NYX						
nyy	NYY						
nza	NZA						
nzb	NZB						
nzd	NZD						
nzi	NZI	NZI	nzi	NZI	nzi		
nzk	NZK						
nzm	NZM						
nzs	NZS						
nzu	NZU						
nzy	NZY						
nzz	NZZ						
oaa	OAA						
oac	OAC						
oar	OAR						
oav	OAV						
obi	OBI						
obk	OBK						
obl	OBL						
obm	OBM						
obo	OBO						
obr	OBR						
obt	OBT						
obu	OBU						
oca	OCA						
och	OCH						
oci	OCI	OCI	oci	OCI	oci	oc	OC
oco	OCO						
ocu	OCU						
oda	ODA						
odk	ODK						
odt	ODT						
odu	ODU						
ofo	OFO						
ofs	OFS						
ofu	OFU						
ogb	OGB						
ogc	OGC						
oge	OGE						
ogg	OGG						
ogo	OGO						
ogu	OGU						
oht	OHT						
ohu	OHU						
oia	OIA						
oin	OIN						
ojb	OJB						
ojc	OJC						
ojg	OJG						
oji	OJI	OJI	oji	OJI	oji	oj	OJ
ojp	OJP						
ojs	OJS						
ojv	OJV						
ojw	OJW						
oka	OKA						
okb	OKB						
okd	OKD						
oke	OKE						
okg	OKG						
okh	OKH						
oki	OKI						
okj	OKJ						
okk	OKK						
okl	OKL						
okm	OKM						
okn	OKN						
oko	OKO						
okr	OKR						
oks	OKS						
oku	OKU						
okv	OKV						
okx	OKX						
ola	OLA						
old	OLD						
ole	OLE						
olk	OLK						
olm	OLM						
olo	OLO						
olr	OLR						
olt	OLT						
olu	OLU						
oma	OMA						
omb	OMB						
omc	OMC						
omg	OMG						
omi	OMI						
omk	OMK						
oml	OML						
omn	OMN						
omo	OMO						
omp	OMP						
omr	OMR						
omt	OMT						
omu	OMU						
omw	OMW						
omx	OMX						
ona	ONA						
onb	ONB						
one	ONE						
ong	ONG						
oni	ONI						
onj	ONJ						
onk	ONK						
onn	ONN						
ono	ONO						
onp	ONP						
onr	ONR						
ons	ONS						
ont	ONT						
onu	ONU						
onw	ONW						
onx	ONX						
ood	OOD						
oog	OOG						
oon	OON						
oor	OOR						
oos	OOS						
opa	OPA						
opk	OPK						
opm	OPM						
opo	OPO						
opt	OPT						
opy	OPY						
ora	ORA						
orc	ORC						
ore	ORE						
org	ORG						
orh	ORH						
ori	ORI	ORI	ori	ORI	ori	or	OR
orm	ORM	ORM	orm	ORM	orm	om	OM
orn	ORN						
oro	ORO						
orr	ORR						
ors	ORS						
ort	ORT						
oru	ORU						
orv	ORV						
orw	ORW						
orx	ORX						
ory	ORY						
orz	ORZ						
osa	OSA	OSA	osa	OSA	osa		
osc	OSC						
osi	OSI						
oso	OSO						
osp	OSP						
oss	OSS	OSS	oss	OSS	oss	os	OS
ost	OST						
osu	OSU						
osx	OSX						
ota	OTA	OTA	ota	OTA	ota		
otb	OTB						
otd	OTD						
ote	OTE						
oti	OTI						
otk	OTK						
otl	OTL						
otm	OTM						
otn	OTN						
otq	OTQ						
otr	OTR						
ots	OTS						
ott	OTT						
otu	OTU						
otw	OTW						
otx	OTX						
oty	OTY						
otz	OTZ						
oua	OUA						
oub	OUB						
oue	OUE						
oui	OUI						
oum	OUM						
ovd	OVD						
owi	OWI						
owl	OWL						
oyb	OYB						
oyd	OYD						
oym	OYM						
oyy	OYY						
ozm	OZM						
pab	PAB						
pac	PAC						
pad	PAD						
pae	PAE						
paf	PAF						
pag	PAG	PAG	pag	PAG	pag		
pah	PAH						
pai	PAI						
pak	PAK						
pal	PAL	PAL	pal	PAL	pal		
pam	PAM	PAM	pam	PAM	pam		
pan	PAN	PAN	pan	PAN	pan	pa	PA
pao	PAO						
pap	PAP	PAP	pap	PAP	pap		
paq	PAQ						
par	PAR						
pas	PAS						
pat	PAT						
pau	PAU	PAU	pau	PAU	pau		
pav	PAV						
paw	PAW						
pax	PAX						
pay	PAY						
paz	PAZ						
pbb	PBB						
pbc	PBC						
pbe	PBE						
pbf	PBF						
pbg	PBG						
pbh	PBH						
pbi	PBI						
pbl	PBL						
pbm	PBM						
pbn	PBN						
pbo	PBO						
pbp	PBP						
pbr	PBR						
pbs	PBS						
pbt	PBT						
pbu	PBU						
pbv	PBV						
pby	PBY						
pca	PCA						
pcb	PCB						
pcc	PCC						
pcd	PCD						
pce	PCE						
pcf	PCF						
pcg	PCG						
pch	PCH						
pci	PCI						
pcj	PCJ						
pck	PCK						
pcl	PCL						
pcm	PCM						
pcn	PCN						
pcp	PCP						
pcw	PCW						
pda	PDA						
pdc	PDC						
pdi	PDI						
pdn	PDN						
pdo	PDO						
pdt	PDT						
pdu	PDU						
pea	PEA						
peb	PEB						
ped	PED						
pee	PEE						
pef	PEF						
peg	PEG						
peh	PEH						
pei	PEI						
pej	PEJ						
pek	PEK						
pel	PEL						
pem	PEM						
peo	PEO	PEO	peo	PEO	peo		
pep	PEP						
peq	PEQ						
pes	PES						
pev	PEV						
pex	PEX						
pey	PEY						
pez	PEZ						
pfa	PFA						
pfe	PFE						
pfl	PFL						
pga	PGA						
pgd	PGD						
pgg	PGG						
pgi	PGI						
pgk	PGK						
pgl	PGL						
pgn	PGN						
pgs	PGS						
pgu	PGU						
pgz	PGZ						
pha	PHA						
phd	PHD						
phg	PHG						
phh	PHH						
phk	PHK						
phl	PHL						
phm	PHM						
phn	PHN	PHN	phn	PHN	phn		
pho	PHO						
phq	PHQ						
phr	PHR						
pht	PHT						
phu	PHU						
phv	PHV						
phw	PHW						
pia	PIA						
pib	PIB						
pic	PIC						
pid	PID						
pie	PIE						
pif	PIF						
pig	PIG						
pih	PIH						
pii	PII						
pij	PIJ						
pil	PIL						
pim	PIM						
pin	PIN						
pio	PIO						
pip	PIP						
pir	PIR						
pis	PIS						
pit	PIT						
piu	PIU						
piv	PIV						
piw	PIW						
pix	PIX						
piy	PIY						
piz	PIZ						
pjt	PJT						
pka	PKA						
pkb	PKB						
pkc	PKC						
pkg	PKG						
pkh	PKH						
pkn	PKN						
pko	PKO						
pkp	PKP						
pkr	PKR						
pks	PKS						
pkt	PKT						
pku	PKU						
pla	PLA						
plb	PLB						
plc	PLC						
pld	PLD						
ple	PLE						
plg	PLG						
plh	PLH						
pli	PLI	PLI	pli	PLI	pli	pi	PI
plj	PLJ						
plk	PLK						
pll	PLL						
pln	PLN						
plo	PLO						
plq	PLQ						
plr	PLR						
pls	PLS						
plt	PLT						
plu	PLU						
plv	PLV						
plw	PLW						
ply	PLY						
plz	PLZ						
pma	PMA						
pmb	PMB						
pmd	PMD						
pme	PME						
pmf	PMF						
pmh	PMH						
pmi	PMI						
pmj	PMJ						
pmk	PMK						
pml	PML						
pmm	PMM						
pmn	PMN						
pmo	PMO						
pmq	PMQ						
pmr	PMR						
pms	PMS						
pmt	PMT						
pmw	PMW						
pmx	PMX						
pmy	PMY						
pmz	PMZ						
pna	PNA						
pnb	PNB						
pnc	PNC						
pnd	PND						
pne	PNE						
png	PNG						
pnh	PNH						
pni	PNI						
pnj	PNJ						
pnk	PNK						
pnl	PNL						
pnm	PNM						
pnn	PNN						
pno	PNO						
pnp	PNP						
pnq	PNQ						
pnr	PNR						
pns	PNS						
pnt	PNT						
pnu	PNU						
pnv	PNV						
pnw	PNW						
pnx	PNX						
pny	PNY						
pnz	PNZ						
poc	POC						
poe	POE						
pof	POF						
pog	POG						
poh	POH						
poi	POI						
pok	POK						
pol	POL	POL	pol	POL	pol	pl	PL
pom	POM						
pon	PON	PON	pon	PON	pon		
poo	POO						
pop	POP						
poq	POQ						
por	POR	POR	por	POR	por	pt	PT
pos	POS						
pot	POT						
pov	POV						
pow	POW						
pox	POX						
poy	POY						
ppe	PPE						
ppi	PPI						
ppk	PPK						
ppl	PPL						
ppm	PPM						
ppn	PPN						
ppo	PPO						
ppp	PPP						
ppq	PPQ						
pps	PPS						
ppt	PPT						
ppu	PPU						
pqa	PQA						
pqm	PQM						
prc	PRC						
prd	PRD						
pre	PRE						
prf	PRF						
prg	PRG						
prh	PRH						
pri	PRI						
prk	PRK						
prl	PRL						
prm	PRM						
prn	PRN						
pro	PRO	PRO	pro	PRO	pro		
prp	PRP						
prq	PRQ						
prr	PRR						
prs	PRS						
prt	PRT						
pru	PRU						
prw	PRW						
prx	PRX						
prz	PRZ						
psa	PSA						
psc	PSC						
psd	PSD						
pse	PSE						
psg	PSG						
psh	PSH						
psi	PSI						
psl	PSL						
psm	PSM						
psn	PSN						
pso	PSO						
psp	PSP						
psq	PSQ						
psr	PSR						
pss	PSS						
pst	PST						
psu	PSU						
psw	PSW						
psy	PSY						
pta	PTA						
pth	PTH						
pti	PTI						
ptn	PTN						
pto	PTO						
ptp	PTP						
ptq	PTQ						
ptr	PTR						
ptt	PTT						
ptu	PTU						
ptv	PTV						
ptw	PTW						
pty	PTY						
pua	PUA						
pub	PUB						
puc	PUC						
pud	PUD						
pue	PUE						
puf	PUF						
pug	PUG						
pui	PUI						
puj	PUJ						
pum	PUM						
puo	PUO						
pup	PUP						
puq	PUQ						
pur	PUR						
pus	PUS	PUS	pus	PUS	pus	ps	PS
put	PUT						
puu	PUU						
puw	PUW						
pux	PUX						
puy	PUY						
pwa	PWA						
pwb	PWB						
pwg	PWG						
pwi	PWI						
pwm	PWM						
pwn	PWN						
pwo	PWO						
pwr	PWR						
pww	PWW						
pxm	PXM						
pye	PYE						
pym	PYM						
pyn	PYN						
pys	PYS						
pyu	PYU						
pyx	PYX						
pyy	PYY						
pzn	PZN						
qua	QUA						
qub	QUB						
quc	QUC						
qud	QUD						
que	QUE	QUE	que	QUE	que	qu	QU
quf	QUF						
qug	QUG						
quh	QUH						
qui	QUI						
quk	QUK						
qul	QUL						
qum	QUM						
qun	QUN						
qup	QUP						
quq	QUQ						
qur	QUR						
qus	QUS						
quv	QUV						
quw	QUW						
qux	QUX						
quy	QUY						
quz	QUZ						
qva	QVA						
qvc	QVC						
qve	QVE						
qvh	QVH						
qvi	QVI						
qvj	QVJ						
qvl	QVL						
qvm	QVM						
qvn	QVN						
qvo	QVO						
qvp	QVP						
qvs	QVS						
qvw	QVW						
qvy	QVY						
qvz	QVZ						
qwa	QWA						
qwc	QWC						
qwh	QWH						
qwm	QWM						
qws	QWS						
qwt	QWT						
qxa	QXA						
qxc	QXC						
qxh	QXH						
qxl	QXL						
qxn	QXN						
qxo	QXO						
qxp	QXP						
qxq	QXQ						
qxr	QXR						
qxs	QXS						
qxt	QXT						
qxu	QXU						
qxw	QXW						
qya	QYA						
qyp	QYP						
raa	RAA						
rab	RAB						
rac	RAC						
rad	RAD						
raf	RAF						
rag	RAG						
rah	RAH						
rai	RAI						
raj	RAJ	RAJ	raj	RAJ	raj		
rak	RAK						
ral	RAL						
ram	RAM						
ran	RAN						
rao	RAO						
rap	RAP	RAP	rap	RAP	rap		
raq	RAQ						
rar	RAR	RAR	rar	RAR	rar		
ras	RAS						
rat	RAT						
rau	RAU						
rav	RAV						
raw	RAW						
rax	RAX						
ray	RAY						
raz	RAZ						
rbb	RBB						
rbk	RBK						
rbl	RBL						
rbp	RBP						
rcf	RCF						
rdb	RDB						
rea	REA						
reb	REB						
ree	REE						
reg	REG						
rei	REI						
rej	REJ						
rel	REL						
rem	REM						
ren	REN						
rer	RER						
res	RES						
ret	RET						
rey	REY						
rga	RGA						
rge	RGE						
rgk	RGK						
rgn	RGN						
rgr	RGR						
rgs	RGS						
rgu	RGU						
rhg	RHG						
rhp	RHP						
ria	RIA						
rif	RIF						
ril	RIL						
rim	RIM						
rin	RIN						
rir	RIR						
rit	RIT						
riu	RIU						
rjg	RJG						
rji	RJI						
rjs	RJS						
rka	RKA						
rkb	RKB						
rkh	RKH						
rki	RKI						
rkm	RKM						
rkt	RKT						
rkw	RKW						
rma	RMA						
rmb	RMB						
rmc	RMC						
rmd	RMD						
rme	RME						
rmf	RMF						
rmg	RMG						
rmh	RMH						
rmi	RMI						
rmk	RMK						
rml	RML						
rmm	RMM						
rmn	RMN						
rmo	RMO						
rmp	RMP						
rmq	RMQ						
rms	RMS						
rmt	RMT						
rmu	RMU						
rmv	RMV						
rmw	RMW						
rmx	RMX						
rmy	RMY						
rmz	RMZ						
rnd	RND						
rng	RNG						
rnl	RNL						
rnn	RNN						
rnp	RNP						
rnr	RNR						
rnw	RNW						
rob	ROB						
roc	ROC						
rod	ROD						
roe	ROE						
rof	ROF						
rog	ROG						
roh	ROH	ROH	roh	ROH	roh	rm	RM
rol	ROL						
rom	ROM	ROM	rom	ROM	rom		
ron	RON	RUM	rum	RON	ron	ro	RO
roo	ROO						
rop	ROP						
ror	ROR						
rou	ROU						
row	ROW						
rpn	RPN						
rpt	RPT						
rri	RRI						
rro	RRO						
rrt	RRT						
rsb	RSB						
rsl	RSL						
rsm	RSM						
rtc	RTC						
rth	RTH						
rtm	RTM						
rts	RTS						
rtw	RTW						
rub	RUB						
ruc	RUC						
rue	RUE						
ruf	RUF						
rug	RUG						
ruh	RUH						
rui	RUI						
ruk	RUK						
run	RUN	RUN	run	RUN	run	rn	RN
ruo	RUO						
rup	RUP	RUP	rup	RUP	rup		
ruq	RUQ						
rus	RUS	RUS	rus	RUS	rus	ru	RU
rut	RUT						
ruu	RUU						
ruy	RUY						
ruz	RUZ						
rwa	RWA						
rwk	RWK						
rwm	RWM						
rwo	RWO						
rwr	RWR						
rxd	RXD						
rxw	RXW						
ryn	RYN						
rys	RYS						
ryu	RYU						
rzh	RZH						
saa	SAA						
sab	SAB						
sac	SAC						
sad	SAD	SAD	sad	SAD	sad		
sae	SAE						
saf	SAF						
sag	SAG	SAG	sag	SAG	sag	sg	SG
sah	SAH	SAH	sah	SAH	sah		
saj	SAJ						
sak	SAK						
sam	SAM	SAM	sam	SAM	sam		
san	SAN	SAN	san	SAN	san	sa	SA
sao	SAO						
saq	SAQ						
sar	SAR						
sas	SAS	SAS	sas	SAS	sas		
sat	SAT	SAT	sat	SAT	sat		
sau	SAU						
sav	SAV						
saw	SAW						
sax	SAX						
say	SAY						
saz	SAZ						
sba	SBA						
sbb	SBB						
sbc	SBC						
sbd	SBD						
sbe	SBE						
sbf	SBF						
sbg	SBG						
sbh	SBH						
sbi	SBI						
sbj	SBJ						
sbk	SBK						
sbl	SBL						
sbm	SBM						
sbn	SBN						
sbo	SBO						
sbp	SBP						
sbq	SBQ						
sbr	SBR						
sbs	SBS						
sbt	SBT						
sbu	SBU						
sbv	SBV						
sbw	SBW						
sbx	SBX						
sby	SBY						
sbz	SBZ						
scb	SCB						
sce	SCE						
scf	SCF						
scg	SCG						
sch	SCH						
sci	SCI						
sck	SCK						
scl	SCL						
scn	SCN	SCN	scn	SCN	scn		
sco	SCO	SCO	sco	SCO	sco		
scp	SCP						
scq	SCQ						
scs	SCS						
sct	SCT						
scu	SCU						
scv	SCV						
scw	SCW						
scx	SCX						
sda	SDA						
sdb	SDB						
sdc	SDC						
sde	SDE						
sdf	SDF						
sdg	SDG						
sdh	SDH						
sdj	SDJ						
sdk	SDK						
sdl	SDL						
sdn	SDN						
sdo	SDO						
sdp	SDP						
sdq	SDQ						
sdr	SDR						
sds	SDS						
sdt	SDT						
sdu	SDU						
sdx	SDX						
sdz	SDZ						
sea	SEA						
seb	SEB						
sec	SEC						
sed	SED						
see	SEE						
sef	SEF						
seg	SEG						
seh	SEH						
sei	SEI						
sej	SEJ						
sek	SEK						
sel	SEL	SEL	sel	SEL	sel		
sen	SEN						
seo	SEO						
sep	SEP						
seq	SEQ						
ser	SER						
ses	SES						
set	SET						
seu	SEU						
sev	SEV						
sew	SEW						
sey	SEY						
sez	SEZ						
sfb	SFB						
sfe	SFE						
sfm	SFM						
sfs	SFS						
sfw	SFW						
sga	SGA	SGA	sga	SGA	sga		
sgb	SGB						
sgc	SGC						
sgd	SGD						
sge	SGE						
sgg	SGG						
sgh	SGH						
sgi	SGI						
sgj	SGJ						
sgk	SGK						
sgm	SGM						
sgp	SGP						
sgr	SGR						
sgs	SGS						
sgt	SGT						
sgu	SGU						
sgw	SGW						
sgx	SGX						
sgy	SGY						
sgz	SGZ						
sha	SHA						
shb	SHB						
shc	SHC						
shd	SHD						
she	SHE						
shg	SHG						
shh	SHH						
shi	SHI						
shj	SHJ						
shk	SHK						
shl	SHL						
shm	SHM						
shn	SHN	SHN	shn	SHN	shn		
sho	SHO						
shp	SHP						
shq	SHQ						
shr	SHR						
shs	SHS						
sht	SHT						
shu	SHU						
shv	SHV						
shw	SHW						
shx	SHX						
shy	SHY						
shz	SHZ						
sia	SIA						
sib	SIB						
sid	SID	SID	sid	SID	sid		
sie	SIE						
sif	SIF						
sig	SIG						
sih	SIH						
sii	SII						
sij	SIJ						
sik	SIK						
sil	SIL						
sim	SIM						
sin	SIN	SIN	sin	SIN	sin	si	SI
sip	SIP						
siq	SIQ						
sir	SIR						
sis	SIS						
siu	SIU						
siv	SIV						
siw	SIW						
six	SIX						
siy	SIY						
siz	SIZ						
sja	SJA						
sjb	SJB						
sjd	SJD						
sje	SJE						
sjg	SJG						
sjk	SJK						
sjl	SJL						
sjm	SJM						
sjn	SJN						
sjo	SJO						
sjp	SJP						
sjr	SJR						
sjs	SJS						
sjt	SJT						
sju	SJU						
sjw	SJW						
ska	SKA						
skb	SKB						
skc	SKC						
skd	SKD						
ske	SKE						
skf	SKF						
skg	SKG						
skh	SKH						
ski	SKI						
skj	SKJ						
skm	SKM						
skn	SKN						
sko	SKO						
skp	SKP						
skq	SKQ						
skr	SKR						
sks	SKS						
skt	SKT						
sku	SKU						
skv	SKV						
skw	SKW						
skx	SKX						
sky	SKY						
skz	SKZ						
slc	SLC						
sld	SLD						
sle	SLE						
slf	SLF						
slg	SLG						
slh	SLH						
sli	SLI						
slj	SLJ						
slk	SLK	SLO	slo	SLK	slk	sk	SK
sll	SLL						
slm	SLM						
sln	SLN						
slp	SLP						
slq	SLQ						
slr	SLR						
sls	SLS						
slt	SLT						
slu	SLU						
slv	SLV	SLV	slv	SLV	slv	sl	SL
slw	SLW						
slx	SLX						
sly	SLY						
slz	SLZ						
sma	SMA	SMA	sma	SMA	sma		
smb	SMB						
smc	SMC						
smd	SMD						
sme	SME	SME	sme	SME	sme	se	SE
smf	SMF						
smg	SMG						
smh	SMH						
smj	SMJ	SMJ	smj	SMJ	smj		
smk	SMK						
sml	SML						
smm	SMM						
smn	SMN	SMN	smn	SMN	smn		
smo	SMO	SMO	smo	SMO	smo	sm	SM
smp	SMP						
smq	SMQ						
smr	SMR						
sms	SMS	SMS	sms	SMS	sms		
smt	SMT						
smu	SMU						
smv	SMV						
smw	SMW						
smx	SMX						
smy	SMY						
smz	SMZ						
sna	SNA	SNA	sna	SNA	sna	sn	SN
snb	SNB						
snc	SNC						
snd	SND	SND	snd	SND	snd	sd	SD
sne	SNE						
snf	SNF						
sng	SNG						
sni	SNI						
snj	SNJ						
snk	SNK	SNK	snk	SNK	snk		
snl	SNL						
snm	SNM						
snn	SNN						
sno	SNO						
snp	SNP						
snq	SNQ						
snr	SNR						
sns	SNS						
snu	SNU						
snv	SNV						
snw	SNW						
snx	SNX						
sny	SNY						
snz	SNZ						
soa	SOA						
sob	SOB						
soc	SOC						
sod	SOD						
soe	SOE						
sog	SOG	SOG	sog	SOG	sog		
soh	SOH						
soi	SOI						
soj	SOJ						
sok	SOK						
sol	SOL						
som	SOM	SOM	som	SOM	som	so	SO
soo	SOO						
sop	SOP						
soq	SOQ						
sor	SOR						
sos	SOS						
sot	SOT	SOT	sot	SOT	sot	st	ST
sou	SOU						
sov	SOV						
sow	SOW						
sox	SOX						
soy	SOY						
soz	SOZ						
spa	SPA	SPA	spa	SPA	spa	es	ES
spb	SPB						
spc	SPC						
spd	SPD						
spe	SPE						
spg	SPG						
spi	SPI						
spk	SPK						
spl	SPL						
spm	SPM						
spn	SPN						
spo	SPO						
spp	SPP						
spq	SPQ						
spr	SPR						
sps	SPS						
spt	SPT						
spu	SPU						
spv	SPV						
spx	SPX						
spy	SPY						
sqa	SQA						
sqh	SQH						
sqi	SQI	ALB	alb	SQI	sqi	sq	SQ
sqk	SQK						
sqm	SQM						
sqn	SQN						
sqo	SQO						
sqq	SQQ						
sqr	SQR						
sqs	SQS						
sqt	SQT						
squ	SQU						
sra	SRA						
srb	SRB						
src	SRC						
srd	SRD	SRD	srd	SRD	srd	sc	SC
sre	SRE						
srf	SRF						
srg	SRG						
srh	SRH						
sri	SRI						
srk	SRK						
srl	SRL						
srm	SRM						
srn	SRN	SRN	srn	SRN	srn		
sro	SRO						
srp	SRP	SRP	srp	SRP	srp	sr	SR
srq	SRQ						
srr	SRR	SRR	srr	SRR	srr		
srs	SRS						
srt	SRT						
sru	SRU						
srv	SRV						
srw	SRW						
srx	SRX						
sry	SRY						
srz	SRZ						
ssb	SSB						
ssc	SSC						
ssd	SSD						
sse	SSE						
ssf	SSF						
ssg	SSG						
ssh	SSH						
ssi	SSI						
ssj	SSJ						
ssk	SSK						
ssl	SSL						
ssm	SSM						
ssn	SSN						
sso	SSO						
ssp	SSP						
ssq	SSQ						
ssr	SSR						
sss	SSS						
sst	SST						
ssu	SSU						
ssv	SSV						
ssw	SSW	SSW	ssw	SSW	ssw	ss	SS
ssx	SSX						
ssy	SSY						
ssz	SSZ						
sta	STA						
stb	STB						
std	STD						
ste	STE						
stf	STF						
stg	STG						
sth	STH						
sti	STI						
stj	STJ						
stk	STK						
stl	STL						
stm	STM						
stn	STN						
sto	STO						
stp	STP						
stq	STQ						
str	STR						
sts	STS						
stt	STT						
stu	STU						
stv	STV						
stw	STW						
sty	STY						
sua	SUA						
sub	SUB						
suc	SUC						
sue	SUE						
sug	SUG						
sui	SUI						
suj	SUJ						
suk	SUK	SUK	suk	SUK	suk		
sun	SUN	SUN	sun	SUN	sun	su	SU
suq	SUQ						
sur	SUR						
sus	SUS	SUS	sus	SUS	sus		
sut	SUT						
suv	SUV						
suw	SUW						
sux	SUX	SUX	sux	SUX	sux		
suy	SUY						
suz	SUZ						
sva	SVA						
svb	SVB						
svc	SVC						
sve	SVE						
svk	SVK						
svm	SVM						
svs	SVS						
svx	SVX						
swa	SWA	SWA	swa	SWA	swa	sw	SW
swb	SWB						
swc	SWC						
swe	SWE	SWE	swe	SWE	swe	sv	SV
swf	SWF						
swg	SWG						
swh	SWH						
swi	SWI						
swj	SWJ						
swk	SWK						
swl	SWL						
swm	SWM						
swn	SWN						
swo	SWO						
swp	SWP						
swq	SWQ						
swr	SWR						
sws	SWS						
swt	SWT						
swu	SWU						
swv	SWV						
sww	SWW						
swx	SWX						
swy	SWY						
sxb	SXB						
sxc	SXC						
sxe	SXE						
sxg	SXG						
sxk	SXK						
sxl	SXL						
sxm	SXM						
sxn	SXN						
sxo	SXO						
sxr	SXR						
sxs	SXS						
sxu	SXU						
sxw	SXW						
sya	SYA						
syb	SYB						
syc	SYC	SYC	syc	SYC	syc		
syi	SYI						
syk	SYK						
syl	SYL						
sym	SYM						
syn	SYN						
syo	SYO						
syr	SYR	SYR	syr	SYR	syr		
sys	SYS						
syw	SYW						
syx	SYX						
syy	SYY						
sza	SZA						
szb	SZB						
szc	SZC						
szd	SZD						
sze	SZE						
szg	SZG						
szl	SZL						
szn	SZN						
szp	SZP						
szs	SZS						
szv	SZV						
szw	SZW						
szy	SZY						
taa	TAA						
tab	TAB						
tac	TAC						
tad	TAD						
tae	TAE						
taf	TAF						
tag	TAG						
tah	TAH	TAH	tah	TAH	tah	ty	TY
taj	TAJ						
tak	TAK						
tal	TAL						
tam	TAM	TAM	tam	TAM	tam	ta	TA
tan	TAN						
tao	TAO						
tap	TAP						
taq	TAQ						
tar	TAR						
tas	TAS						
tat	TAT	TAT	tat	TAT	tat	tt	TT
tau	TAU						
tav	TAV						
taw	TAW						
tax	TAX						
tay	TAY						
taz	TAZ						
tba	TBA						
tbc	TBC						
tbd	TBD						
tbe	TBE						
tbf	TBF						
tbg	TBG						
tbh	TBH						
tbi	TBI						
tbj	TBJ						
tbk	TBK						
tbl	TBL						
tbm	TBM						
tbn	TBN						
tbo	TBO						
tbp	TBP						
tbr	TBR						
tbs	TBS						
tbt	TBT						
tbu	TBU						
tbv	TBV						
tbw	TBW						
tbx	TBX						
tby	TBY						
tbz	TBZ						
tca	TCA						
tcb	TCB						
tcc	TCC						
tcd	TCD						
tce	TCE						
tcf	TCF						
tcg	TCG						
tch	TCH						
tci	TCI						
tck	TCK						
tcl	TCL						
tcm	TCM						
tcn	TCN						
tco	TCO						
tcp	TCP						
tcq	TCQ						
tcs	TCS						
tct	TCT						
tcu	TCU						
tcw	TCW						
tcx	TCX						
tcy	TCY						
tcz	TCZ						
tda	TDA						
tdb	TDB						
tdc	TDC						
tdd	TDD						
tde	TDE						
tdf	TDF						
tdg	TDG						
tdh	TDH						
tdi	TDI						
tdj	TDJ						
tdk	TDK						
tdl	TDL						
tdm	TDM						
tdn	TDN						
tdo	TDO						
tdq	TDQ						
tdr	TDR						
tds	TDS						
tdt	TDT						
tdv	TDV						
tdx	TDX						
tdy	TDY						
tea	TEA						
teb	TEB						
tec	TEC						
ted	TED						
tee	TEE						
tef	TEF						
teg	TEG						
teh	TEH						
tei	TEI						
tek	TEK						
tel	TEL	TEL	tel	TEL	tel	te	TE
tem	TEM	TEM	tem	TEM	tem		
ten	TEN						
teo	TEO						
tep	TEP						
teq	TEQ						
ter	TER	TER	ter	TER	ter		
tes	TES						
tet	TET	TET	tet	TET	tet		
teu	TEU						
tev	TEV						
tew	TEW						
tex	TEX						
tey	TEY						
tez	TEZ						
tfi	TFI						
tfn	TFN						
tfo	TFO						
tfr	TFR						
tft	TFT						
tga	TGA						
tgb	TGB						
tgc	TGC						
tgd	TGD						
tge	TGE						
tgf	TGF						
tgh	TGH						
tgi	TGI						
tgj	TGJ						
tgk	TGK	TGK	tgk	TGK	tgk	tg	TG
tgl	TGL	TGL	tgl	TGL	tgl	tl	TL
tgn	TGN						
tgo	TGO						
tgp	TGP						
tgq	TGQ						
tgr	TGR						
tgs	TGS						
tgt	TGT						
tgu	TGU						
tgv	TGV						
tgw	TGW						
tgx	TGX						
tgy	TGY						
tgz	TGZ						
tha	THA	THA	tha	THA	tha	th	TH
thd	THD						
the	THE						
thf	THF						
thh	THH						
thi	THI						
thk	THK						
thl	THL						
thm	THM						
thn	THN						
thp	THP						
thq	THQ						
thr	THR						
ths	THS						
tht	THT						
thu	THU						
thv	THV						
thy	THY						
thz	THZ						
tia	TIA						
tic	TIC						
tif	TIF						
tig	TIG	TIG	tig	TIG	tig		
tih	TIH						
tii	TII						
tij	TIJ						
tik	TIK						
til	TIL						
tim	TIM						
tin	TIN						
tio	TIO						
tip	TIP						
tiq	TIQ						
tir	TIR	TIR	tir	TIR	tir	ti	TI
tis	TIS						
tit	TIT						
tiu	TIU						
tiv	TIV	TIV	tiv	TIV	tiv		
tiw	TIW						
tix	TIX						
tiy	TIY						
tiz	TIZ						
tja	TJA						
tjg	TJG						
tji	TJI						
tjj	TJJ						
tjl	TJL						
tjm	TJM						
tjn	TJN						
tjo	TJO						
tjp	TJP						
tjs	TJS						
tju	TJU						
tjw	TJW						
tka	TKA						
tkb	TKB						
tkd	TKD						
tke	TKE						
tkf	TKF						
tkg	TKG						
tkl	TKL	TKL	tkl	TKL	tkl		
tkm	TKM						
tkn	TKN						
tkp	TKP						
tkq	TKQ						
tkr	TKR						
tks	TKS						
tkt	TKT						
tku	TKU						
tkv	TKV						
tkw	TKW						
tkx	TKX						
tkz	TKZ						
tla	TLA						
tlb	TLB						
tlc	TLC						
tld	TLD						
tlf	TLF						
tlg	TLG						
tlh	TLH	TLH	tlh	TLH	tlh		
tli	TLI	TLI	tli	TLI	tli		
tlj	TLJ						
tlk	TLK						
tll	TLL						
tlm	TLM						
tln	TLN						
tlo	TLO						
tlp	TLP						
tlq	TLQ						
tlr	TLR						
tls	TLS						
tlt	TLT						
tlu	TLU						
tlv	TLV						
tlx	TLX						
tly	TLY						
tma	TMA						
tmb	TMB						
tmc	TMC						
tmd	TMD						
tme	TME						
tmf	TMF						
tmg	TMG						
tmh	TMH	TMH	tmh	TMH	tmh		
tmi	TMI						
tmj	TMJ						
tmk	TMK						
tml	TML						
tmm	TMM						
tmn	TMN						
tmo	TMO						
tmq	TMQ						
tmr	TMR						
tms	TMS						
tmt	TMT						
tmu	TMU						
tmv	TMV						
tmw	TMW						
tmy	TMY						
tmz	TMZ						
tna	TNA						
tnb	TNB						
tnc	TNC						
tnd	TND						
tng	TNG						
tnh	TNH						
tni	TNI						
tnk	TNK						
tnl	TNL						
tnm	TNM						
tnn	TNN						
tno	TNO						
tnp	TNP						
tnq	TNQ						
tnr	TNR						
tns	TNS						
tnt	TNT						
tnu	TNU						
tnv	TNV						
tnw	TNW						
tnx	TNX						
tny	TNY						
tnz	TNZ						
tob	TOB						
toc	TOC						
tod	TOD						
tof	TOF						
tog	TOG	TOG	tog	TOG	tog		
toh	TOH						
toi	TOI						
toj	TOJ						
tol	TOL						
tom	TOM						
ton	TON	TON	ton	TON	ton	to	TO
too	TOO						
top	TOP						
toq	TOQ						
tor	TOR						
tos	TOS						
tou	TOU						
tov	TOV						
tow	TOW						
tox	TOX						
toy	TOY						
toz	TOZ						
tpa	TPA						
tpc	TPC						
tpe	TPE						
tpf	TPF						
tpg	TPG						
tpi	TPI	TPI	tpi	TPI	tpi		
tpj	TPJ						
tpk	TPK						
tpl	TPL						
tpm	TPM						
tpn	TPN						
tpo	TPO						
tpp	TPP						
tpq	TPQ						
tpr	TPR						
tpt	TPT						
tpu	TPU						
tpv	TPV						
tpw	TPW						
tpx	TPX						
tpy	TPY						
tpz	TPZ						
tqb	TQB						
tql	TQL						
tqm	TQM						
tqn	TQN						
tqo	TQO						
tqp	TQP						
tqq	TQQ						
tqr	TQR						
tqt	TQT						
tqu	TQU						
tqw	TQW						
tra	TRA						
trb	TRB						
trc	TRC						
trd	TRD						
tre	TRE						
trf	TRF						
trg	TRG						
trh	TRH						
tri	TRI						
trj	TRJ						
trl	TRL						
trm	TRM						
trn	TRN						
tro	TRO						
trp	TRP						
trq	TRQ						
trr	TRR						
trs	TRS						
trt	TRT						
tru	TRU						
trv	TRV						
trw	TRW						
trx	TRX						
try	TRY						
trz	TRZ						
tsa	TSA						
tsb	TSB						
tsc	TSC						
tsd	TSD						
tse	TSE						
tsg	TSG						
tsh	TSH						
tsi	TSI	TSI	tsi	TSI	tsi		
tsj	TSJ						
tsk	TSK						
tsl	TSL						
tsm	TSM						
tsn	TSN	TSN	tsn	TSN	tsn	tn	TN
tso	TSO	TSO	tso	TSO	tso	ts	TS
tsp	TSP						
tsq	TSQ						
tsr	TSR						
tss	TSS						
tst	TST						
tsu	TSU						
tsv	TSV						
tsw	TSW						
tsx	TSX						
tsy	TSY						
tsz	TSZ						
tta	TTA						
ttb	TTB						
ttc	TTC						
ttd	TTD						
tte	TTE						
ttf	TTF						
ttg	TTG						
tth	TTH						
tti	TTI						
ttj	TTJ						
ttk	TTK						
ttl	TTL						
ttm	TTM						
ttn	TTN						
tto	TTO						
ttp	TTP						
ttq	TTQ						
ttr	TTR						
tts	TTS						
ttt	TTT						
ttu	TTU						
ttv	TTV						
ttw	TTW						
tty	TTY						
ttz	TTZ						
tua	TUA						
tub	TUB						
tuc	TUC						
tud	TUD						
tue	TUE						
tuf	TUF						
tug	TUG						
tuh	TUH						
tui	TUI						
tuj	TUJ						
tuk	TUK	TUK	tuk	TUK	tuk	tk	TK
tul	TUL						
tum	TUM	TUM	tum	TUM	tum		
tun	TUN						
tuo	TUO						
tuq	TUQ						
tur	TUR	TUR	tur	TUR	tur	tr	TR
tus	TUS						
tuu	TUU						
tuv	TUV						
tux	TUX						
tuy	TUY						
tuz	TUZ						
tva	TVA						
tvd	TVD						
tve	TVE						
tvk	TVK						
tvl	TVL	TVL	tvl	TVL	tvl		
tvm	TVM						
tvn	TVN						
tvo	TVO						
tvs	TVS						
tvt	TVT						
tvu	TVU						
tvw	TVW						
tvx	TVX						
tvy	TVY						
twa	TWA						
twb	TWB						
twc	TWC						
twd	TWD						
twe	TWE						
twf	TWF						
twg	TWG						
twh	TWH						
twi	TWI	TWI	twi	TWI	twi	tw	TW
twl	TWL						
twm	TWM						
twn	TWN						
two	TWO						
twp	TWP						
twq	TWQ						
twr	TWR						
twt	TWT						
twu	TWU						
tww	TWW						
twx	TWX						
twy	TWY						
txa	TXA						
txb	TXB						
txc	TXC						
txe	TXE						
txg	TXG						
txh	TXH						
txi	TXI						
txj	TXJ						
txm	TXM						
txn	TXN						
txo	TXO						
txq	TXQ						
txr	TXR						
txs	TXS						
txt	TXT						
txu	TXU						
txx	TXX						
txy	TXY						
tya	TYA						
tye	TYE						
tyh	TYH						
tyi	TYI						
tyj	TYJ						
tyl	TYL						
tyn	TYN						
typ	TYP						
tyr	TYR						
tys	TYS						
tyt	TYT						
tyu	TYU						
tyv	TYV	TYV	tyv	TYV	tyv		
tyx	TYX						
tyz	TYZ						
tza	TZA						
tzh	TZH						
tzj	TZJ						
tzl	TZL						
tzm	TZM						
tzn	TZN						
tzo	TZO						
tzx	TZX						
uam	UAM						
uan	UAN						
uar	UAR						
uba	UBA						
ubi	UBI						
ubl	UBL						
ubr	UBR						
ubu	UBU						
uby	UBY						
uda	UDA						
ude	UDE						
udg	UDG						
udi	UDI						
udj	UDJ						
udl	UDL						
udm	UDM	UDM	udm	UDM	udm		
udu	UDU						
ues	UES						
ufi	UFI						
uga	UGA	UGA	uga	UGA	uga		
ugb	UGB						
uge	UGE						
ugn	UGN						
ugo	UGO						
ugy	UGY						
uha	UHA						
uhn	UHN						
uig	UIG	UIG	uig	UIG	uig	ug	UG
uis	UIS						
uiv	UIV						
uji	UJI						
uka	UKA						
ukg	UKG						
ukh	UKH						
uki	UKI						
ukk	UKK						
ukl	UKL						
ukp	UKP						
ukq	UKQ						
ukr	UKR	UKR	ukr	UKR	ukr	uk	UK
uks	UKS						
uku	UKU						
ukv	UKV						
ukw	UKW						
uky	UKY						
ula	ULA						
ulb	ULB						
ulc	ULC						
ule	ULE						
ulf	ULF						
uli	ULI						
ulk	ULK						
ull	ULL						
ulm	ULM						
uln	ULN						
ulu	ULU						
ulw	ULW						
uma	UMA						
umb	UMB	UMB	umb	UMB	umb		
umc	UMC						
umd	UMD						
umg	UMG						
umi	UMI						
umm	UMM						
umn	UMN						
umo	UMO						
ump	UMP						
umr	UMR						
ums	UMS						
umu	UMU						
una	UNA						
und	UND	UND	und	UND	und		
une	UNE						
ung	UNG						
unk	UNK						
unm	UNM						
unn	UNN						
unr	UNR						
unu	UNU						
unx	UNX						
unz	UNZ						
upi	UPI						
upv	UPV						
ura	URA						
urb	URB						
urc	URC						
urd	URD	URD	urd	URD	urd	ur	UR
ure	URE						
urf	URF						
urg	URG						
urh	URH						
uri	URI						
urk	URK						
url	URL						
urm	URM						
urn	URN						
uro	URO						
urp	URP						
urr	URR						
urt	URT						
uru	URU						
urv	URV						
urw	URW						
urx	URX						
ury	URY						
urz	URZ						
usa	USA						
ush	USH						
usi	USI						
usk	USK						
usp	USP						
uss	USS						
usu	USU						
uta	UTA						
ute	UTE						
uth	UTH						
utp	UTP						
utr	UTR						
utu	UTU						
uum	UUM						
uun	UUN						
uur	UUR						
uuu	UUU						
uve	UVE						
uvh	UVH						
uvl	UVL						
uwa	UWA						
uya	UYA						
uzb	UZB	UZB	uzb	UZB	uzb	uz	UZ
uzn	UZN						
uzs	UZS						
vaa	VAA						
vae	VAE						
vaf	VAF						
vag	VAG						
vah	VAH						
vai	VAI	VAI	vai	VAI	vai		
vaj	VAJ						
val	VAL						
vam	VAM						
van	VAN						
vao	VAO						
vap	VAP						
var	VAR						
vas	VAS						
vau	VAU						
vav	VAV						
vay	VAY						
vbb	VBB						
vbk	VBK						
vec	VEC						
ved	VED						
vel	VEL						
vem	VEM						
ven	VEN	VEN	ven	VEN	ven	ve	VE
veo	VEO						
vep	VEP						
ver	VER						
vgr	VGR						
vgt	VGT						
vic	VIC						
vid	VID						
vie	VIE	VIE	vie	VIE	vie	vi	VI
vif	VIF						
vig	VIG						
vil	VIL						
vin	VIN						
vis	VIS						
vit	VIT						
viv	VIV						
vka	VKA						
vki	VKI						
vkj	VKJ						
vkk	VKK						
vkl	VKL						
vkm	VKM						
vko	VKO						
vkp	VKP						
vkt	VKT						
vku	VKU						
vlp	VLP						
vls	VLS						
vma	VMA						
vmb	VMB						
vmc	VMC						
vmd	VMD						
vme	VME						
vmf	VMF						
vmg	VMG						
vmh	VMH						
vmi	VMI						
vmj	VMJ						
vmk	VMK						
vml	VML						
vmm	VMM						
vmp	VMP						
vmq	VMQ						
vmr	VMR						
vms	VMS						
vmu	VMU						
vmv	VMV						
vmw	VMW						
vmx	VMX						
vmy	VMY						
vmz	VMZ						
vnk	VNK						
vnm	VNM						
vnp	VNP						
vol	VOL	VOL	vol	VOL	vol	vo	VO
vor	VOR						
vot	VOT	VOT	vot	VOT	vot		
vra	VRA						
vro	VRO						
vrs	VRS						
vrt	VRT						
vsi	VSI						
vsl	VSL						
vsv	VSV						
vto	VTO						
vum	VUM						
vun	VUN						
vut	VUT						
vwa	VWA						
waa	WAA						
wab	WAB						
wac	WAC						
wad	WAD						
wae	WAE						
waf	WAF						
wag	WAG						
wah	WAH						
wai	WAI						
waj	WAJ						
wal	WAL	WAL	wal	WAL	wal		
wam	WAM						
wan	WAN						
wao	WAO						
wap	WAP						
waq	WAQ						
war	WAR	WAR	war	WAR	war		
was	WAS	WAS	was	WAS	was		
wat	WAT						
wau	WAU						
wav	WAV						
waw	WAW						
wax	WAX						
way	WAY						
waz	WAZ						
wba	WBA						
wbb	WBB						
wbe	WBE						
wbf	WBF						
wbh	WBH						
wbi	WBI						
wbj	WBJ						
wbk	WBK						
wbl	WBL						
wbm	WBM						
wbp	WBP						
wbq	WBQ						
wbr	WBR						
wbs	WBS						
wbt	WBT						
wbv	WBV						
wbw	WBW						
wca	WCA						
wci	WCI						
wdd	WDD						
wdg	WDG						
wdj	WDJ						
wdk	WDK						
wdu	WDU						
wdy	WDY						
wea	WEA						
wec	WEC						
wed	WED						
weg	WEG						
weh	WEH						
wei	WEI						
wem	WEM						
weo	WEO						
wep	WEP						
wer	WER						
wes	WES						
wet	WET						
weu	WEU						
wew	WEW						
wfg	WFG						
wga	WGA						
wgb	WGB						
wgg	WGG						
wgi	WGI						
wgo	WGO						
wgu	WGU						
wgy	WGY						
wha	WHA						
whg	WHG						
whk	WHK						
whu	WHU						
wib	WIB						
wic	WIC						
wie	WIE						
wif	WIF						
wig	WIG						
wih	WIH						
wii	WII						
wij	WIJ						
wik	WIK						
wil	WIL						
wim	WIM						
win	WIN						
wir	WIR						
wiu	WIU						
wiv	WIV						
wiy	WIY						
wja	WJA						
wji	WJI						
wka	WKA						
wkb	WKB						
wkd	WKD						
wkl	WKL						
wkr	WKR						
wku	WKU						
wkw	WKW						
wky	WKY						
wla	WLA						
wlc	WLC						
wle	WLE						
wlg	WLG						
wlh	WLH						
wli	WLI						
wlk	WLK						
wll	WLL						
wlm	WLM						
wln	WLN	WLN	wln	WLN	wln	wa	WA
wlo	WLO						
wlr	WLR						
wls	WLS						
wlu	WLU						
wlv	WLV						
wlw	WLW						
wlx	WLX						
wly	WLY						
wma	WMA						
wmb	WMB						
wmc	WMC						
wmd	WMD						
wme	WME						
wmh	WMH						
wmi	WMI						
wmm	WMM						
wmn	WMN						
wmo	WMO						
wms	WMS						
wmt	WMT						
wmw	WMW						
wmx	WMX						
wnb	WNB						
wnc	WNC						
wnd	WND						
wne	WNE						
wng	WNG						
wni	WNI						
wnk	WNK						
wnm	WNM						
wnn	WNN						
wno	WNO						
wnp	WNP						
wnu	WNU						
wnw	WNW						
wny	WNY						
woa	WOA						
wob	WOB						
woc	WOC						
wod	WOD						
woe	WOE						
wof	WOF						
wog	WOG						
woi	WOI						
wok	WOK						
wol	WOL	WOL	wol	WOL	wol	wo	WO
wom	WOM						
won	WON						
woo	WOO						
wor	WOR						
wos	WOS						
wow	WOW						
woy	WOY						
wpc	WPC						
wra	WRA						
wrb	WRB						
wrd	WRD						
wrg	WRG						
wrh	WRH						
wri	WRI						
wrk	WRK						
wrl	WRL						
wrm	WRM						
wrn	WRN						
wro	WRO						
wrp	WRP						
wrr	WRR						
wrs	WRS						
wru	WRU						
wrv	WRV						
wrw	WRW						
wrx	WRX						
wry	WRY						
wrz	WRZ						
wsa	WSA						
wsg	WSG						
wsi	WSI						
wsk	WSK						
wsr	WSR						
wss	WSS						
wsu	WSU						
wsv	WSV						
wtf	WTF						
wth	WTH						
wti	WTI						
wtk	WTK						
wtm	WTM						
wtw	WTW						
wua	WUA						
wub	WUB						
wud	WUD						
wuh	WUH						
wul	WUL						
wum	WUM						
wun	WUN						
wur	WUR						
wut	WUT						
wuu	WUU						
wuv	WUV						
wux	WUX						
wuy	WUY						
wwa	WWA						
wwb	WWB						
wwo	WWO						
wwr	WWR						
www	WWW						
wxa	WXA						
wxw	WXW						
wya	WYA						
wyb	WYB						
wyi	WYI						
wym	WYM						
wyr	WYR						
wyy	WYY						
xaa	XAA						
xab	XAB						
xac	XAC						
xad	XAD						
xae	XAE						
xag	XAG						
xai	XAI						
xaj	XAJ						
xak	XAK						
xal	XAL	XAL	xal	XAL	xal		
xam	XAM						
xan	XAN						
xao	XAO						
xap	XAP						
xaq	XAQ						
xar	XAR						
xas	XAS						
xat	XAT						
xau	XAU						
xav	XAV						
xaw	XAW						
xay	XAY						
xbb	XBB						
xbc	XBC						
xbd	XBD						
xbe	XBE						
xbg	XBG						
xbi	XBI						
xbj	XBJ						
xbm	XBM						
xbn	XBN						
xbo	XBO						
xbp	XBP						
xbr	XBR						
xbw	XBW						
xby	XBY						
xcb	XCB						
xcc	XCC						
xce	XCE						
xcg	XCG						
xch	XCH						
xcl	XCL						
xcm	XCM						
xcn	XCN						
xco	XCO						
xcr	XCR						
xct	XCT						
xcu	XCU						
xcv	XCV						
xcw	XCW						
xcy	XCY						
xda	XDA						
xdc	XDC						
xdk	XDK						
xdm	XDM						
xdo	XDO						
xdy	XDY						
xeb	XEB						
xed	XED						
xeg	XEG						
xel	XEL						
xem	XEM						
xep	XEP						
xer	XER						
xes	XES						
xet	XET						
xeu	XEU						
xfa	XFA						
xga	XGA						
xgb	XGB						
xgd	XGD						
xgf	XGF						
xgg	XGG						
xgi	XGI						
xgl	XGL						
xgm	XGM						
xgr	XGR						
xgu	XGU						
xgw	XGW						
xha	XHA						
xhc	XHC						
xhd	XHD						
xhe	XHE						
xho	XHO	XHO	xho	XHO	xho	xh	XH
xhr	XHR						
xht	XHT						
xhu	XHU						
xhv	XHV						
xib	XIB						
xii	XII						
xil	XIL						
xin	XIN						
xir	XIR						
xis	XIS						
xiv	XIV						
xiy	XIY						
xjb	XJB						
xjt	XJT						
xka	XKA						
xkb	XKB						
xkc	XKC						
xkd	XKD						
xke	XKE						
xkf	XKF						
xkg	XKG						
xki	XKI						
xkj	XKJ						
xkk	XKK						
xkl	XKL						
xkn	XKN						
xko	XKO						
xkp	XKP						
xkq	XKQ						
xkr	XKR						
xks	XKS						
xkt	XKT						
xku	XKU						
xkv	XKV						
xkw	XKW						
xkx	XKX						
xky	XKY						
xkz	XKZ						
xla	XLA						
xlb	XLB						
xlc	XLC						
xld	XLD						
xle	XLE						
xlg	XLG						
xli	XLI						
xln	XLN						
xlo	XLO						
xlp	XLP						
xls	XLS						
xlu	XLU						
xly	XLY						
xma	XMA						
xmb	XMB						
xmc	XMC						
xmd	XMD						
xme	XME						
xmf	XMF						
xmg	XMG						
xmh	XMH						
xmj	XMJ						
xmk	XMK						
xml	XML						
xmm	XMM						
xmn	XMN						
xmo	XMO						
xmp	XMP						
xmq	XMQ						
xmr	XMR						
xms	XMS						
xmt	XMT						
xmu	XMU						
xmv	XMV						
xmw	XMW						
xmx	XMX						
xmy	XMY						
xmz	XMZ						
xna	XNA						
xnb	XNB						
xng	XNG						
xnh	XNH						
xni	XNI						
xnk	XNK						
xnm	XNM						
xnn	XNN						
xno	XNO						
xnr	XNR						
xns	XNS						
xnt	XNT						
xnu	XNU						
xny	XNY						
xnz	XNZ						
xoc	XOC						
xod	XOD						
xog	XOG						
xoi	XOI						
xok	XOK						
xom	XOM						
xon	XON						
xoo	XOO						
xop	XOP						
xor	XOR						
xow	XOW						
xpa	XPA						
xpb	XPB						
xpc	XPC						
xpd	XPD						
xpe	XPE						
xpf	XPF						
xpg	XPG						
xph	XPH						
xpi	XPI						
xpj	XPJ						
xpk	XPK						
xpl	XPL						
xpm	XPM						
xpn	XPN						
xpo	XPO						
xpp	XPP						
xpq	XPQ						
xpr	XPR						
xps	XPS						
xpt	XPT						
xpu	XPU						
xpv	XPV						
xpw	XPW						
xpx	XPX						
xpy	XPY						
xpz	XPZ						
xqa	XQA						
xqt	XQT						
xra	XRA						
xrb	XRB						
xrd	XRD						
xre	XRE						
xrg	XRG						
xri	XRI						
xrm	XRM						
xrn	XRN						
xrr	XRR						
xrt	XRT						
xru	XRU						
xrw	XRW						
xsa	XSA						
xsb	XSB						
xsc	XSC						
xsd	XSD						
xse	XSE						
xsh	XSH						
xsi	XSI						
xsj	XSJ						
xsl	XSL						
xsm	XSM						
xsn	XSN						
xso	XSO						
xsp	XSP						
xsq	XSQ						
xsr	XSR						
xss	XSS						
xsu	XSU						
xsv	XSV						
xsy	XSY						
xta	XTA						
xtb	XTB						
xtc	XTC						
xtd	XTD						
xte	XTE						
xtg	XTG						
xth	XTH						
xti	XTI						
xtj	XTJ						
xtl	XTL						
xtm	XTM						
xtn	XTN						
xto	XTO						
xtp	XTP						
xtq	XTQ						
xtr	XTR						
xts	XTS						
xtt	XTT						
xtu	XTU						
xtv	XTV						
xtw	XTW						
xty	XTY						
xua	XUA						
xub	XUB						
xud	XUD						
xug	XUG						
xuj	XUJ						
xul	XUL						
xum	XUM						
xun	XUN						
xuo	XUO						
xup	XUP						
xur	XUR						
xut	XUT						
xuu	XUU						
xve	XVE						
xvi	XVI						
xvn	XVN						
xvo	XVO						
xvs	XVS						
xwa	XWA						
xwc	XWC						
xwd	XWD						
xwe	XWE						
xwg	XWG						
xwj	XWJ						
xwk	XWK						
xwl	XWL						
xwo	XWO						
xwr	XWR						
xwt	XWT						
xww	XWW						
xxb	XXB						
xxk	XXK						
xxm	XXM						
xxr	XXR						
xxt	XXT						
xya	XYA						
xyb	XYB						
xyj	XYJ						
xyk	XYK						
xyl	XYL						
xyt	XYT						
xyy	XYY						
xzh	XZH						
xzm	XZM						
xzp	XZP						
yaa	YAA						
yab	YAB						
yac	YAC						
yad	YAD						
yae	YAE						
yaf	YAF						
yag	YAG						
yah	YAH						
yai	YAI						
yaj	YAJ						
yak	YAK						
yal	YAL						
yam	YAM						
yan	YAN						
yao	YAO	YAO	yao	YAO	yao		
yap	YAP	YAP	yap	YAP	yap		
yaq	YAQ						
yar	YAR						
yas	YAS						
yat	YAT						
yau	YAU						
yav	YAV						
yaw	YAW						
yax	YAX						
yay	YAY						
yaz	YAZ						
yba	YBA						
ybb	YBB						
ybe	YBE						
ybh	YBH						
ybi	YBI						
ybj	YBJ						
ybk	YBK						
ybl	YBL						
ybm	YBM						
ybn	YBN						
ybo	YBO						
ybx	YBX						
yby	YBY						
ych	YCH						
ycl	YCL						
ycn	YCN						
ycp	YCP						
yda	YDA						
ydd	YDD						
yde	YDE						
ydg	YDG						
ydk	YDK						
yea	YEA						
yec	YEC						
yee	YEE						
yei	YEI						
yej	YEJ						
yel	YEL						
yer	YER						
yes	YES						
yet	YET						
yeu	YEU						
yev	YEV						
yey	YEY						
yga	YGA						
ygi	YGI						
ygl	YGL						
ygm	YGM						
ygp	YGP						
ygr	YGR						
ygs	YGS						
ygu	YGU						
ygw	YGW						
yha	YHA						
yhd	YHD						
yhl	YHL						
yhs	YHS						
yia	YIA						
yid	YID	YID	yid	YID	yid	yi	YI
yif	YIF						
yig	YIG						
yih	YIH						
yii	YII						
yij	YIJ						
yik	YIK						
yil	YIL						
yim	YIM						
yin	YIN						
yip	YIP						
yiq	YIQ						
yir	YIR						
yis	YIS						
yit	YIT						
yiu	YIU						
yiv	YIV						
yix	YIX						
yiz	YIZ						
yka	YKA						
ykg	YKG						
yki	YKI						
ykk	YKK						
ykl	YKL						
ykm	YKM						
ykn	YKN						
yko	YKO						
ykr	YKR						
ykt	YKT						
yku	YKU						
yky	YKY						
yla	YLA						
ylb	YLB						
yle	YLE						
ylg	YLG						
yli	YLI						
yll	YLL						
ylm	YLM						
yln	YLN						
ylo	YLO						
ylr	YLR						
ylu	YLU						
yly	YLY						
ymb	YMB						
ymc	YMC						
ymd	YMD						
yme	YME						
ymg	YMG						
ymh	YMH						
ymi	YMI						
ymk	YMK						
yml	YML						
ymm	YMM						
ymn	YMN						
ymo	YMO						
ymp	YMP						
ymq	YMQ						
ymr	YMR						
yms	YMS						
ymx	YMX						
ymz	YMZ						
yna	YNA						
ynd	YND						
yne	YNE						
yng	YNG						
ynk	YNK						
ynl	YNL						
ynn	YNN						
yno	YNO						
ynq	YNQ						
yns	YNS						
ynu	YNU						
yob	YOB						
yog	YOG						
yoi	YOI						
yok	YOK						
yol	YOL						
yom	YOM						
yon	YON						
yor	YOR	YOR	yor	YOR	yor	yo	YO
yot	YOT						
yox	YOX						
yoy	YOY						
ypa	YPA						
ypb	YPB						
ypg	YPG						
yph	YPH						
ypm	YPM						
ypn	YPN						
ypo	YPO						
ypp	YPP						
ypz	YPZ						
yra	YRA						
yrb	YRB						
yre	YRE						
yrk	YRK						
yrl	YRL						
yrm	YRM						
yrn	YRN						
yro	YRO						
yrs	YRS						
yrw	YRW						
yry	YRY						
ysc	YSC						
ysd	YSD						
ysg	YSG						
ysl	YSL						
ysn	YSN						
yso	YSO						
ysp	YSP						
ysr	YSR						
yss	YSS						
ysy	YSY						
yta	YTA						
ytl	YTL						
ytp	YTP						
ytw	YTW						
yty	YTY						
yua	YUA						
yub	YUB						
yuc	YUC						
yud	YUD						
yue	YUE						
yuf	YUF						
yug	YUG						
yui	YUI						
yuj	YUJ						
yuk	YUK						
yul	YUL						
yum	YUM						
yun	YUN						
yup	YUP						
yuq	YUQ						
yur	YUR						
yut	YUT						
yuw	YUW						
yux	YUX						
yuy	YUY						
yuz	YUZ						
yva	YVA						
yvt	YVT						
ywa	YWA						
ywg	YWG						
ywl	YWL						
ywn	YWN						
ywq	YWQ						
ywr	YWR						
ywt	YWT						
ywu	YWU						
yww	YWW						
yxa	YXA						
yxg	YXG						
yxl	YXL						
yxm	YXM						
yxu	YXU						
yxy	YXY						
yyr	YYR						
yyu	YYU						
yyz	YYZ						
yzg	YZG						
yzk	YZK						
zaa	ZAA						
zab	ZAB						
zac	ZAC						
zad	ZAD						
zae	ZAE						
zaf	ZAF						
zag	ZAG						
zah	ZAH						
zai	ZAI						
zaj	ZAJ						
zak	ZAK						
zal	ZAL						
zam	ZAM						
zao	ZAO						
zap	ZAP	ZAP	zap	ZAP	zap		
zaq	ZAQ						
zar	ZAR						
zas	ZAS						
zat	ZAT						
zau	ZAU						
zav	ZAV						
zaw	ZAW						
zax	ZAX						
zay	ZAY						
zaz	ZAZ						
zba	ZBA						
zbc	ZBC						
zbe	ZBE						
zbl	ZBL	ZBL	zbl	ZBL	zbl		
zbt	ZBT						
zbw	ZBW						
zca	ZCA						
zch	ZCH						
zdj	ZDJ						
zea	ZEA						
zeg	ZEG						
zeh	ZEH						
zen	ZEN	ZEN	zen	ZEN	zen		
zga	ZGA						
zgb	ZGB						
zgh	ZGH	ZGH	zgh	ZGH	zgh		
zgm	ZGM						
zgn	ZGN						
zgr	ZGR						
zha	ZHA	ZHA	zha	ZHA	zha	za	ZA
zhb	ZHB						
zhd	ZHD						
zhi	ZHI						
zhn	ZHN						
zho	ZHO	CHI	chi	ZHO	zho	zh	ZH
zhw	ZHW						
zia	ZIA						
zib	ZIB						
zik	ZIK						
zil	ZIL						
zim	ZIM						
zin	ZIN						
ziw	ZIW						
ziz	ZIZ						
zka	ZKA						
zkb	ZKB						
zkd	ZKD						
zkg	ZKG						
zkh	ZKH						
zkk	ZKK						
zkn	ZKN						
zko	ZKO						
zkp	ZKP						
zkr	ZKR						
zkt	ZKT						
zku	ZKU						
zkv	ZKV						
zkz	ZKZ						
zlj	ZLJ						
zlm	ZLM						
zln	ZLN						
zlq	ZLQ						
zma	ZMA						
zmb	ZMB						
zmc	ZMC						
zmd	ZMD						
zme	ZME						
zmf	ZMF						
zmg	ZMG						
zmh	ZMH						
zmi	ZMI						
zmj	ZMJ						
zmk	ZMK						
zml	ZML						
zmm	ZMM						
zmn	ZMN						
zmo	ZMO						
zmp	ZMP						
zmq	ZMQ						
zmr	ZMR						
zms	ZMS						
zmt	ZMT						
zmu	ZMU						
zmv	ZMV						
zmw	ZMW						
zmx	ZMX						
zmy	ZMY						
zmz	ZMZ						
zna	ZNA						
zne	ZNE						
zng	ZNG						
znk	ZNK						
zns	ZNS						
zoc	ZOC						
zoh	ZOH						
zom	ZOM						
zoo	ZOO						
zoq	ZOQ						
zor	ZOR						
zos	ZOS						
zpa	ZPA						
zpb	ZPB						
zpc	ZPC						
zpd	ZPD						
zpe	ZPE						
zpf	ZPF						
zpg	ZPG						
zph	ZPH						
zpi	ZPI						
zpj	ZPJ						
zpk	ZPK						
zpl	ZPL						
zpm	ZPM						
zpn	ZPN						
zpo	ZPO						
zpp	ZPP						
zpq	ZPQ						
zpr	ZPR						
zps	ZPS						
zpt	ZPT						
zpu	ZPU						
zpv	ZPV						
zpw	ZPW						
zpx	ZPX						
zpy	ZPY						
zpz	ZPZ						
zqe	ZQE						
zra	ZRA						
zrg	ZRG						
zrn	ZRN						
zro	ZRO						
zrp	ZRP						
zrs	ZRS						
zsa	ZSA						
zsk	ZSK						
zsl	ZSL						
zsm	ZSM						
zsr	ZSR						
zsu	ZSU						
zte	ZTE						
ztg	ZTG						
ztl	ZTL						
ztm	ZTM						
ztn	ZTN						
ztp	ZTP						
ztq	ZTQ						
zts	ZTS						
ztt	ZTT						
ztu	ZTU						
ztx	ZTX						
zty	ZTY						
zua	ZUA						
zuh	ZUH						
zul	ZUL	ZUL	zul	ZUL	zul	zu	ZU
zum	ZUM						
zun	ZUN	ZUN	zun	ZUN	zun		
zuy	ZUY						
zwa	ZWA						
zxx	ZXX	ZXX	zxx	ZXX	zxx		
zyb	ZYB						
zyg	ZYG						
zyj	ZYJ						
zyn	ZYN						
zyp	ZYP						
zza	ZZA	ZZA	zza	ZZA	zza		
zzj	ZZJ						
